   6 ять	І
   6 П	ять
   5 Фото	ГДА
   5 ГДА	СБУ
   5 СБУ	2015
   5 те	що
   5 2015	р
   4 українських	архівів
   4 документів	в
   4 в	архівах
   4 INS	INS
   4 2018	_
   4 12	2018
   3 архівну	справу
   3 архіви	мають
   3 навіть	в
   3 в	архівній
   3 в	тому
   3 jpg	Фото
   2 Укрдержархів	має
   2 української	архівної
   2 індексації	документів
   2 соціальних	мережах
   2 Українська	правда
   2 Історична	правда
   2 архівної	реформи
   2 архівній	справі
   2 архівних	послуг
   2 Анатолій	Хромов
   2 цифрових	копій
   2 програми	Пам
   2 говорить	про
   2 Вахтанг	Кіпіані
   2 вільний	доступ
   2 архівів	та
   2 реформи	в
   2 архівів	і
   2 правда	Історична
   2 служби	та
   2 доступ	до
   2 Справа	в
   2 копій	документів
   2 слів	про
   2 лише	при
   2 тому	що
   2 вже	сьогодні
   2 ять	Світу
   2 які	можна
   2 той	час
   2 Пам	ять
   2 час	як
   2 про	те
   2 все	ще
   2 до	програми
   2 до	архівної
   2 як	мінімум
   2 Ці	кроки
   2 та	його
   2 он	лайн
   2 не	було
   2 зв	язки
   2 у	соціальних
   2 у	форматі
   2 в	архівну
   2 в	Україні
   2 в	той
   2 2017	року
   1 ТЕКСТИКОРОТКОКНИЖКИАРТЕФАКТИКОЛОНКИВІДЕОДАЙДЖЕСТІНТЕРВ	ЮСТУДІЇКАЛЕНДАРЕ
   1 центральноєвропейських	країн
   1 загальноукраїнському	рівні
   1 КСКУРСІЇБЛОГОСФЕРА	АВТОРИЗАЦІЯ
   1 Інтернаціональний	міжнародний
   1 ЮСТУДІЇКАЛЕНДАРЕ	КСКУРСІЇБЛОГОСФЕРА
   1 недофінансування	архівів
   1 малодослідженим	залишається
   1 передпенсійного	віку
   1 УВІЙТИВІДМІНИТИ	Якщо
   1 гіперпосиланням	на
   1 ПРОЕКТЗВОРОТНІЙ	ЗВ
   1 інтегрованості	національного
   1 інформаційному	суспільстві
   1 громадянському	суспільству
   1 інформатизації	внутрішніх
   1 централізувати	активність
   1 розповсюдження	передового
   1 реставраційних	матеріалів
   1 культурницьким	установам
   1 документообігу	звітності
   1 Інформатизація	Кількість
   1 культурницьких	установ
   1 Ініціативність	Принцип
   1 лібералізувала	доступ
   1 зареєструйтесь	Забули
   1 Інтегрованість	Врешті
   1 інформатизації	Для
   1 засекречування	та
   1 використовуйте	ті
   1 Загальновідомо	що
   1 інтегрованості	В
   1 затвердженого	українського
   1 нетиражованою	інформацією
   1 таоцифрування	документів
   1 національними	іноземними
   1 національного	архівного
   1 комнезамівців	Причетних
   1 запоказниками	вологості
   1 репрезентації	цифрових
   1 продовжується	тотальне
   1 невмотивовані	заборони
   1 запровадження	цифрових
   1 Чорнобильську	трагедію
   1 перевиконують	планові
   1 впроваджувати	приємні
   1 гендиректорки	ЮНЕСКО
   1 архівознавчої	освіти
   1 інформаційній	епосі
   1 інформаційної	війни
   1 Укрдержархіву	яка
   1 Укрдержархіву	все
   1 співробітники	як
   1 переоснащення	та
   1 краудфандингу	та
   1 краудсорсингу	На
   1 громадськість	до
   1 благодійників	та
   1 Укрдержархіву	на
   1 Документообіг	та
   1 електронного	документообігу
   1 користування	забезпечуючи
   1 внутрішнього	електронного
   1 необхідності	підтвердити
   1 Громадянське	суспільство
   1 європейський	культурний
   1 необхідності	збільшення
   1 недосконалої	нормативно
   1 коментування	публікацій
   1 збереженість	оригіналів
   1 генеалогічну	інформацію
   1 Використання	матеріалів
   1 скандального	нещодавно
   1 неможливості	виконання
   1 користувачів	очевидним
   1 користування	архівними
   1 Застосування	інновацій
   1 зацікавлених	наукових
   1 дослідниками	реальною
   1 використання	архівами
   1 Національний	архівний
   1 фінансування	архівів
   1 українського	Порядку
   1 спеціалістів	частина
   1 сканувальної	техніки
   1 радіопередач	Архівні
   1 обмінюватися	думками
   1 обговорювати	важливі
   1 закордонного	досвіду
   1 забезпечуючи	вільний
   1 інформаційні	панелі
   1 українського	архіву
   1 реформування	можуть
   1 підтримувати	архіви
   1 використання	старих
   1 міжнародному	рівні
   1 керівництвом	людей
   1 Укрдержархів	також
   1 Необхідність	такої
   1 Незалежності	Довга
   1 Варшавському	гетто
   1 скорочуються	Отже
   1 неодноразово	була
   1 затребуваних	які
   1 навантаження	на
   1 користувачів	на
   1 компартійних	зв
   1 волонтерства	як
   1 Укрдержархів	як
   1 європейських	і
   1 збільшується	а
   1 зацікавлення	у
   1 виключеннями	є
   1 міжнародним	культурницьким
   1 максимально	централізувати
   1 авторизації	використовуйте
   1 реставрації	таоцифрування
   1 керівництво	Укрдержархіву
   1 моніторингу	закордонного
   1 українським	дослідникам
   1 російського	попередника
   1 намагається	максимально
   1 найбільшому	культурному
   1 суспільстві	передбачає
   1 репресивних	заборонних
   1 представити	українські
   1 оцифрування	документів
   1 надходження	інвестицій
   1 законодавчо	відкривала
   1 болгарської	комуністки
   1 Оцифрування	документів
   1 єврейського	скаутингу
   1 український	скаутинги
   1 співпрацізі	створення
   1 розвиватися	проявляти
   1 міжнародної	співпраці
   1 міжнародних	контактів
   1 матеріально	технічною
   1 корупційних	скандалів
   1 Яворницький	Козацький
   1 Прикарпатті	оголосили
   1 українських	громадян
   1 температури	Пліснява
   1 позитивного	розвитку
   1 максимально	залучати
   1 користувачі	архівних
   1 забезпечать	системні
   1 дослідження	родинної
   1 центральних	архівів
   1 телепередач	Архівна
   1 суспільству	державі
   1 справжнього	колапсу
   1 сканувальна	техніка
   1 національні	проекти
   1 міжнародний	досвіди
   1 культурному	проекті
   1 дослідників	сервіси
   1 варіюватися	головне
   1 Убезпечення	архівів
   1 цивілізації	Аккаду
   1 реалізувати	навіть
   1 путінського	режиму
   1 переповнені	зайвою
   1 натисканням	однієї
   1 міжнародний	досвід
   1 компенсація	витрат
   1 керівництва	служби
   1 забезпечити	архіви
   1 Українській	правді
   1 Український	портал
   1 Керівництво	служби
   1 український	архів
   1 попередника	кінця
   1 оптимізації	штату
   1 залишаються	копії
   1 забезпечені	умови
   1 інформацією	може
   1 розподілити	ролі
   1 підтвердити	стаж
   1 переляканий	крик
   1 організацій	були
   1 залишається	факт
   1 залишається	лише
   1 суспільство	має
   1 організації	яка
   1 Застосувати	всі
   1 АВТОРИЗАЦІЯ	Для
   1 соціалістки	зі
   1 призначення	на
   1 виправдання	на
   1 ЯЗОКРЕКЛАМА	НА
   1 український	і
   1 звинувачена	у
   1 залишається	в
   1 держбюджету	в
   1 відповідати	В
   1 впроваджено	в
   1 дослідникам	7da92b6
   1 аутсорсингу	2663586
   1 документами	2018
   1 САЙТІАРХІВ	ТЕКСТИКОРОТКОКНИЖКИАРТЕФАКТИКОЛОНКИВІДЕОДАЙДЖЕСТІНТЕРВ
   1 чиновників	передпенсійного
   1 оригіналів	Інтегрованість
   1 унікальною	нетиражованою
   1 технічного	переоснащення
   1 зберігання	запоказниками
   1 невеликими	виключеннями
   1 можливість	обмінюватися
   1 матеріалів	сканувальної
   1 відкидаючи	необхідності
   1 ініціативи	керівництва
   1 постійного	моніторингу
   1 нормальною	Убезпечення
   1 необхідною	матеріально
   1 документів	українських
   1 відвоювати	Застосувати
   1 асигнувань	держбюджету
   1 історичних	документів
   1 іноземними	партнерами
   1 сканування	збереження
   1 руйнування	історичних
   1 профільної	історичної
   1 пропаганду	формалізму
   1 можливості	технічного
   1 збільшення	асигнувань
   1 запитувати	квартальні
   1 Галузевого	державного
   1 технічного	оснащення
   1 системними	рішеннями
   1 радянських	спецслужб
   1 останнього	аргументу
   1 народилися	польський
   1 документів	наприклад
   1 документів	Більшість
   1 банківські	термінали
   1 активності	українців
   1 Польського	інституту
   1 Враховуючи	особистий
   1 російський	архівний
   1 окреслення	основних
   1 огіївських	пиріжків
   1 нормативно	правової
   1 можливості	побачити
   1 квартальні	піврічні
   1 діяльність	Державні
   1 генеалогії	призвели
   1 внутрішніх	процесів
   1 активність	архівних
   1 Безперечно	основним
   1 ініціатива	фахових
   1 інвестицій	зокрема
   1 українські	архівні
   1 українську	архівну
   1 тематичних	форумів
   1 розчавлять	Останні
   1 поліпшення	зведені
   1 передового	досвіду
   1 паритетною	оплатою
   1 паперовими	формами
   1 модернових	практик
   1 культурний	простір
   1 комуністки	пізніше
   1 заборонних	пунктів
   1 документів	охочими
   1 документів	Існують
   1 директорів	архівів
   1 дипломатії	навпаки
   1 Посольство	Ізраїлю
   1 українські	архіви
   1 потенційно	можуть
   1 надсилають	запити
   1 мавпування	Справа
   1 керівників	комусь
   1 збільшення	попиту
   1 додаткових	витрат
   1 державного	архіву
   1 відповідну	роботу
   1 відкривала	доступ
   1 викладають	великі
   1 базуватися	робота
   1 Мілосердов	Огонёк
   1 Державного	архіву
   1 Григоренко	Таврія
   1 історичних	міфів
   1 інформацію	мають
   1 пропозицій	стане
   1 матеріалів	сайту
   1 досягнення	важко
   1 документів	Копії
   1 безперечно	мають
   1 РЕФОРМАЦІЯ	ШАЛОМ
   1 Вінницький	архів
   1 Єврейський	Пласт
   1 історичних	наук
   1 профільних	груп
   1 перебувала	десь
   1 нормативні	акти
   1 наприкінці	року
   1 залучатися	нові
   1 документів	Фото
   1 документів	Тому
   1 інформація	яка
   1 формування	так
   1 сертифікат	про
   1 посиланням	для
   1 документів	для
   1 архівістів	Всі
   1 історичної	чи
   1 інформації	та
   1 технологій	за
   1 співпрацює	зі
   1 публікацій	на
   1 передбачає	те
   1 обурливими	та
   1 обладнання	та
   1 змінюється	та
   1 збереження	та
   1 дослідники	та
   1 дослідники	На
   1 долучаться	до
   1 документів	та
   1 відповідав	за
   1 відзначити	що
   1 важливістю	це
   1 Сподіваюсь	що
   1 Незважаючи	на
   1 Міжнародні	та
   1 ініціативу	а
   1 інформація	є
   1 інвестицій	в
   1 харцерство	і
   1 формалізму	А
   1 підписаний	в
   1 партнерами	у
   1 народжений	в
   1 зберігання	в
   1 десятиліть	в
   1 Фотографія	з
   1 установами	adc6f43
   1 соборність	05
   1 прикладом	центральноєвропейських
   1 спецслужб	лібералізувала
   1 нагальній	інформатизації
   1 сільських	комнезамівців
   1 нещодавно	затвердженого
   1 фактичної	неможливості
   1 тестового	використання
   1 співпраці	Національний
   1 одночасно	збереженість
   1 зменшуючи	навантаження
   1 Залишкове	фінансування
   1 установам	розподілити
   1 співпраці	забезпечать
   1 скаутингу	організації
   1 особистий	український
   1 наприклад	представити
   1 більшості	українських
   1 архівними	документами
   1 Європіані	найбільшому
   1 інновації	Безперечно
   1 співпрацю	потенційно
   1 скаутинги	харцерство
   1 рішеннями	сканування
   1 проявляти	ініціативу
   1 проводити	відповідну
   1 переймати	російський
   1 знаходять	можливості
   1 директора	Галузевого
   1 віддалено	надсилають
   1 Зростання	активності
   1 Волонтери	долучаться
   1 іноземних	партнерів
   1 інновацій	неможливе
   1 продовжує	копіювати
   1 наприклад	Державний
   1 копіювати	тенденції
   1 контактів	Безумовно
   1 знаходять	дивовижну
   1 звітність	паралізує
   1 заступник	директора
   1 жаліються	керівники
   1 дублюючою	звітністю
   1 активісти	знаходять
   1 Олімпіади	викликала
   1 КАНАДІАНА	РЕВОЛЮЦІЯ
   1 створення	цифрових
   1 програмні	продукти
   1 принципів	отримали
   1 попередні	принципи
   1 покращити	ситуацію
   1 дозволять	архівним
   1 дивовижну	схожість
   1 виконання	основних
   1 викликала	неабияке
   1 викладені	архівами
   1 більшості	громадян
   1 архівіста	припадає
   1 Ліксандри	вдаривши
   1 ЕКОНОМІКА	ПОЛІТИКА
   1 Державної	архівної
   1 установам	України
   1 становища	архівів
   1 слугувати	зразком
   1 підтримці	режимів
   1 противагу	заходам
   1 отримання	довідки
   1 оголосили	конкурс
   1 найкращих	архівах
   1 мільйонів	доларів
   1 мовчазний	чоловік
   1 локальних	успіхів
   1 корисного	принесе
   1 керівники	архівів
   1 виконання	запитів
   1 вигукував	команди
   1 Тимошенко	Генерал
   1 Кількість	одиниць
   1 Київської	області
   1 інституту	нацпам
   1 страхував	якийсь
   1 спровокує	широку
   1 рукописів	Рядові
   1 польський	аналог
   1 показники	роботи
   1 паралізує	роботи
   1 невеликій	статті
   1 напрямами	Багато
   1 комуніста	Дмитра
   1 заповнені	значна
   1 ефективну	модель
   1 документи	грають
   1 відкритий	доступ
   1 Січеслава	Дніпра
   1 Концепція	архіву
   1 Козацький	Батько
   1 ГОЛОДОМОР	ВОЛИНЬ
   1 Історичну	правду
   1 технічною	базою
   1 сучасними	Архів
   1 поліпшити	життя
   1 периферії	уваги
   1 загальних	рисах
   1 виставити	описи
   1 архівісти	мають
   1 архівного	фонду
   1 Державний	архів
   1 Інновації	Окрім
   1 страхував	мене
   1 складають	фонд
   1 насправді	було
   1 наскільки	мені
   1 картотека	Фото
   1 дозволено	лише
   1 випустили	кулю
   1 ідеологію	Він
   1 термінали	для
   1 створення	баз
   1 співпраці	але
   1 скандалів	яка
   1 партнерів	сам
   1 неможливе	без
   1 аргументу	під
   1 актуально	для
   1 Голокосту	США
   1 Більшість	цих
   1 цинічними	бо
   1 тенденції	та
   1 секретаря	ЦК
   1 резонують	як
   1 принципів	на
   1 приміщень	на
   1 прикладом	по
   1 польський	та
   1 пересувні	та
   1 оснащення	та
   1 матєрілся	не
   1 зрозуміло	що
   1 звітності	та
   1 зводиться	до
   1 зауважень	та
   1 залишивши	за
   1 закупівля	та
   1 відбулись	не
   1 включення	до
   1 Росархіва	та
   1 Причетних	до
   1 Безумовно	що
   1 українців	у
   1 співпрацю	з
   1 працювали	в
   1 повстання	у
   1 перебуває	в
   1 очевидним	є
   1 концепція	П
   1 звітністю	І
   1 вологості	і
   1 Концепція	П
   1 стратегія	digitalarchives
   1 Сверстюка	25
   1 Понеділок	20
   1 РЕВОЛЮЦІЯ	100
   1 тотальне	засекречування
   1 постійно	впроваджувати
   1 залучати	громадськість
   1 заборони	Укрдержархіву
   1 сенсорні	інформаційні
   1 постійно	скорочуються
   1 неабияке	зацікавлення
   1 найбільш	затребуваних
   1 відділів	Укрдержархів
   1 багатьох	європейських
   1 схожість	репресивних
   1 проривом	української
   1 приклади	позитивного
   1 потрібне	відповідати
   1 показник	оцифрування
   1 осередок	єврейського
   1 древньої	цивілізації
   1 Інтернет	Український
   1 цифрових	технологій
   1 слабкого	технічного
   1 скаутинг	народжений
   1 потребує	окреслення
   1 постійно	перебувала
   1 полюбляє	запитувати
   1 окремими	установами
   1 можливої	індексації
   1 майбутні	українські
   1 колекції	документів
   1 колекція	документів
   1 зроблена	Сподіваюсь
   1 знищення	історичних
   1 виставки	документів
   1 архівної	інформації
   1 архівної	дипломатії
   1 Протягом	десятиліть
   1 Кандидат	історичних
   1 сьогодні	поліпшити
   1 створити	ефективну
   1 римської	Олімпіади
   1 паперова	звітність
   1 основних	принципів
   1 окремими	напрямами
   1 літерами	принципів
   1 критично	заповнені
   1 архівним	установам
   1 архівами	віддалено
   1 ГОЛОКОСТ	ГОЛОДОМОР
   1 сьогодні	відвідує
   1 сучасної	цифрової
   1 століття	показник
   1 передача	сучасної
   1 загибелі	древньої
   1 завітали	невідомі
   1 гарантом	належної
   1 Висновок	Принципи
   1 імітуючи	активну
   1 частиною	історії
   1 цифрової	техніки
   1 установи	України
   1 сторіччя	Колонки
   1 системні	процеси
   1 розвитку	установ
   1 родинної	історії
   1 ресурсом	Архівна
   1 останній	відомий
   1 основних	функцій
   1 місячний	цейтнот
   1 мобільні	додатки
   1 контролю	аналізу
   1 етичного	питання
   1 допомога	архівам
   1 джерелом	сталого
   1 випадках	частина
   1 багатьох	архівах
   1 архівної	системи
   1 архівних	установ
   1 Одеської	області
   1 інтернет	видань
   1 сьогодні	багато
   1 сучасних	умовах
   1 сторінки	давніх
   1 справжні	фанати
   1 сміливці	навіть
   1 процесів	архіви
   1 принципи	досить
   1 нинішніх	умовах
   1 головних	причин
   1 відвідує	значна
   1 вдаються	цікаві
   1 архівної	справи
   1 архівної	служби
   1 архівної	галузі
   1 архівний	досвід
   1 Пліснява	грибок
   1 Державні	архіви
   1 ДАЙДЖЕСТ	ІНТЕРВ
   1 Бондарук	Дмитро
   1 Архипчук	Справа
   1 старшого	брата
   1 реальною	стане
   1 піврічні	звіти
   1 провести	пошук
   1 прикладу	кожен
   1 покарати	бодай
   1 отримали	назву
   1 отримала	назву
   1 останній	пункт
   1 належної	уваги
   1 архівній	сфері
   1 архівної	сфери
   1 архівної	кризи
   1 архівами	мають
   1 Галичини	виник
   1 правової	бази
   1 кризовий	стан
   1 загальні	риси
   1 відсутня	будь
   1 виводити	звіт
   1 архівний	фонд
   1 психушка	Нью
   1 продукти	які
   1 припадає	все
   1 практиці	теж
   1 побачити	хто
   1 основним	має
   1 виставку	про
   1 ятровичу	на
   1 призвели	до
   1 останній	за
   1 обласних	та
   1 наукових	та
   1 каденції	на
   1 знахідки	та
   1 заважати	їм
   1 громадян	до
   1 водночас	цю
   1 включена	до
   1 виходила	на
   1 викинуті	на
   1 ведуться	за
   1 вдаривши	її
   1 вбивства	не
   1 будівлях	де
   1 архівами	та
   1 апелюють	до
   1 ситуація	є
   1 ситуацію	в
   1 сателіта	Б
   1 проектів	у
   1 присутні	і
   1 принципи	і
   1 працюють	з
   1 працюють	в
   1 пиріжків	В
   1 отримати	в
   1 особливо	у
   1 невідомі	і
   1 колекції	в
   1 знайдено	А
   1 дискусію	а
   1 громадян	і
   1 акаунтом	у
   1 Принципи	П
   1 ПОЛІТИКА	RSS
   1 потрібно	75b471b
   1 максимум	5
   1 трагедію	1986
   1 сприяти	інтегрованості
   1 принцип	інтегрованості
   1 досвіду	Інформатизація
   1 України	громадянському
   1 форматі	краудфандингу
   1 техніка	Документообіг
   1 рахунок	благодійників
   1 України	Укрдержархіву
   1 форматі	волонтерства
   1 систему	внутрішнього
   1 пунктів	скандального
   1 охочими	дослідниками
   1 народів	Укрдержархів
   1 нагадує	використання
   1 містять	генеалогічну
   1 агресор	Громадянське
   1 Україні	Необхідність
   1 Порядку	користування
   1 Майдані	Незалежності
   1 шлейфом	корупційних
   1 сталого	надходження
   1 секунди	натисканням
   1 пізніше	соціалістки
   1 процеси	реставрації
   1 користі	українським
   1 відомої	болгарської
   1 відомий	міжнародний
   1 архівах	залишається
   1 архівам	залишаються
   1 агресії	путінського
   1 історії	генеалогії
   1 фахових	керівників
   1 ракурсі	пропаганду
   1 одиниць	зберігання
   1 натовпі	розчавлять
   1 архівів	радянських
   1 архівів	викладають
   1 активну	діяльність
   1 Одіссея	Державного
   1 Валерій	Мілосердов
   1 Архівна	інформація
   1 частині	виконання
   1 частина	перебуває
   1 форматі	тестового
   1 учасник	повстання
   1 установ	резонують
   1 успіхів	відбулись
   1 суттєво	покращити
   1 сильний	мовчазний
   1 простір	наприклад
   1 проекти	співпраці
   1 приклад	виставити
   1 планові	показники
   1 питання	приміщень
   1 заходам	Державної
   1 запитів	Волонтери
   1 дружини	Ліксандри
   1 десятки	мільйонів
   1 виникла	Концепція
   1 архівні	документи
   1 Зокрема	активісти
   1 Архівна	картотека
   1 Існують	програмні
   1 історії	багатьох
   1 історію	архівної
   1 цільове	знищення
   1 функції	контролю
   1 установ	постійно
   1 установ	особливо
   1 столиці	Галичини
   1 системи	Висновок
   1 причину	загибелі
   1 першими	літерами
   1 окремих	випадках
   1 назвати	проривом
   1 карткою	сенсорні
   1 зразком	архівної
   1 десятка	обласних
   1 архівів	постійно
   1 архівів	Анатолій
   1 архівні	колекції
   1 архівну	дискусію
   1 архівах	відсутня
   1 України	сьогодні
   1 Сховища	критично
   1 Принцип	говорить
   1 КОЛОНКИ	ДАЙДЖЕСТ
   1 Архівні	установи
   1 Архівні	знахідки
   1 історія	України
   1 ясували	причину
   1 цейтнот	готуючи
   1 функцій	можливе
   1 установ	Україна
   1 стійким	шлейфом
   1 розписи	установ
   1 реально	втілити
   1 принесе	Україні
   1 пошуках	грантів
   1 окремих	установ
   1 негайно	вводити
   1 назріла	Читайте
   1 зведені	воєдино
   1 загалом	Сховища
   1 досвіди	виникла
   1 відомий	учасник
   1 вводити	систему
   1 архівах	України
   1 Міхаіла	Суслова
   1 КОРОТКО	КОЛОНКИ
   1 Бокової	відомої
   1 Близько	десятка
   1 Архівна	Одіссея
   1 частина	кроків
   1 цифрові	архіви
   1 техніки	оплата
   1 проекті	Європи
   1 програм	обміну
   1 порядок	більше
   1 плодить	країна
   1 керівні	посади
   1 жодного	місяця
   1 довідки	витягу
   1 готуючи	річний
   1 архівів	Методи
   1 архівах	щороку
   1 архівах	навіть
   1 Останні	тексти
   1 Нестача	коштів
   1 Гашомер	Гацаїр
   1 ГОЛОВНА	ТЕКСТИ
   1 тиснули	ззаду
   1 реформи	давно
   1 першому	місці
   1 останні	тижні
   1 оплатою	праці
   1 області	хтось
   1 області	Деякі
   1 назвати	одним
   1 конкурс	есеїв
   1 держава	зобов
   1 далеких	ночей
   1 архівів	можна
   1 Читайте	також
   1 України	сягає
   1 Подібні	угоди
   1 Коротко	Вчені
   1 Генерал	Петро
   1 ІСТОРІЯ	БЛОГИ
   1 частина	яких
   1 тиснули	наші
   1 техніки	тощо
   1 сервіси	зони
   1 предків	тощо
   1 можливе	лише
   1 додатки	тощо
   1 важливі	теми
   1 архівам	слід
   1 Суслова	який
   1 чоловік	Він
   1 установ	пам
   1 практик	які
   1 команди	він
   1 доларів	США
   1 архівів	про
   1 архівів	від
   1 України	ХХІ
   1 Україна	має
   1 Кіпіані	Про
   1 форумів	де
   1 установ	за
   1 створив	он
   1 родинні	зв
   1 приємні	та
   1 правило	не
   1 питання	чи
   1 описати	ті
   1 навпаки	це
   1 мінімум	не
   1 мережах	та
   1 зокрема	це
   1 змінити	Ці
   1 думками	та
   1 досвіду	та
   1 державі	та
   1 держави	до
   1 грантів	та
   1 головне	це
   1 воєдино	за
   1 бюджету	за
   1 архівах	ще
   1 аналізу	та
   1 Україні	це
   1 Україна	за
   1 Ізраїлю	не
   1 формами	і
   1 режимів	В
   1 проекту	в
   1 побачив	у
   1 колапсу	і
   1 клавіши	і
   1 завдяки	а
   1 забутим	і
   1 джерело	у
   1 втілити	в
   1 архівам	у
   1 Фейсбук	і
   1 України	є
   1 Стрибок	у
   1 мережах	ico01
   1 архівів	e369730
   1 Кіпіані	INS
   1 Колонки	72d0794
   1 мінімум	3
   1 Україні	28
   1 початку	21
   1 Бандеру	04
   1 умовах	недофінансування
   1 видань	гіперпосиланням
   1 такого	Ініціативність
   1 умовах	інформаційної
   1 справи	перевиконують
   1 посаді	гендиректорки
   1 Рядові	співробітники
   1 щороку	збільшується
   1 старих	компартійних
   1 правда	Використання
   1 пошуку	зацікавлених
   1 царині	міжнародних
   1 робота	українських
   1 можуть	варіюватися
   1 мантру	виправдання
   1 доступ	українських
   1 досвід	співпрацізі
   1 Дмитро	Яворницький
   1 ідеалі	Враховуючи
   1 чудово	співпрацює
   1 тексти	Єврейський
   1 різних	модернових
   1 послуг	дослідники
   1 посади	чиновників
   1 обліку	документів
   1 зразки	обладнання
   1 заново	відвоювати
   1 архіву	Міжнародні
   1 архіви	необхідною
   1 архіви	безперечно
   1 Справа	огіївських
   1 Львові	народилися
   1 цікаві	пересувні
   1 тісної	співпраці
   1 словом	інновації
   1 просто	страхував
   1 орбіті	Росархіва
   1 одного	архівіста
   1 коштів	Залишкове
   1 зайвою	дублюючою
   1 давніх	рукописів
   1 голові	випустили
   1 архіви	знаходять
   1 Євгена	Сверстюка
   1 ЄВРОПА	ЕКОНОМІКА
   1 цінним	ресурсом
   1 хочемо	отримати
   1 старих	будівлях
   1 причин	архівної
   1 освіти	Протягом
   1 оплати	архівних
   1 онлайн	виставки
   1 наразі	викинуті
   1 навіть	колекції
   1 комусь	вдаються
   1 зжирає	сторінки
   1 архіву	Одеської
   1 Хромов	Кандидат
   1 Тамара	Архипчук
   1 Москва	психушка
   1 Врешті	останній
   1 якийсь	сильний
   1 штатні	розписи
   1 широку	архівну
   1 тільки	народів
   1 стадії	проекту
   1 справу	десятки
   1 служби	України
   1 роботи	родинні
   1 правда	ГОЛОВНА
   1 послуг	карткою
   1 однієї	клавіши
   1 навіть	цільове
   1 масове	джерело
   1 лічені	секунди
   1 кшталт	Нестача
   1 країна	агресор
   1 значна	частина
   1 досить	реально
   1 галузі	загалом
   1 більше	нагадує
   1 багато	користі
   1 архіви	історія
   1 ТЕКСТИ	КОРОТКО
   1 фанати	справи
   1 участь	більше
   1 справі	нормою
   1 приніс	багато
   1 навіть	боявся
   1 можете	увійти
   1 модель	архіву
   1 масиви	описів
   1 довіру	архіви
   1 витрат	архіву
   1 великі	масиви
   1 більше	роботи
   1 Таврія	Москва
   1 Огонёк	Суслов
   1 Забули	пароль
   1 Гацаїр	Десять
   1 єдиний	задум
   1 справу	через
   1 правді	Логін
   1 портал	Шукай
   1 оплата	праці
   1 нормою	стало
   1 можуть	влити
   1 значна	група
   1 званої	Білої
   1 грибок	щодня
   1 відомо	жоден
   1 вулицю	після
   1 більше	людей
   1 ЮНЕСКО	Однак
   1 ЮНЕСКО	Ірини
   1 Дмитра	Коржа
   1 спиною	Мене
   1 річний	звіт
   1 роботи	усіх
   1 роботи	Хоча
   1 раніше	далі
   1 перший	план
   1 обміну	Світ
   1 когось	було
   1 грають	роль
   1 багато	чого
   1 архіву	який
   1 архіву	Крім
   1 Десять	слів
   1 фондів	або
   1 уявити	без
   1 уперед	два
   1 увійти	під
   1 стояли	так
   1 статті	маю
   1 справі	Без
   1 правду	ПРО
   1 панелі	які
   1 нацпам	яті
   1 кроків	вже
   1 зручні	для
   1 заходи	які
   1 доступ	тим
   1 доступ	для
   1 архіву	СБУ
   1 аналог	вже
   1 Версія	для
   1 щільно	що
   1 роботу	із
   1 роботи	на
   1 режиму	на
   1 попиту	на
   1 погляд	ця
   1 пароль	що
   1 пароль	Ви
   1 описів	он
   1 навіть	як
   1 місяця	не
   1 запити	на
   1 досвід	та
   1 витягу	чи
   1 вважає	за
   1 боявся	що
   1 Путіна	та
   1 Методи	та
   1 Європи	де
   1 умовах	і
   1 справу	в
   1 перший	в
   1 однієї	з
   1 зомлію	і
   1 жіноча	ж
   1 досвід	в
   1 впадає	у
   1 витрат	з
   1 більше	і
   1 архіву	П
   1 архіви	у
   1 архіви	з
   1 архіви	в
   1 Суслов	і
   1 Москви	в
   1 Батько	з
   1 Багато	в
   1 ІНТЕРВ	Ю
   1 ЗНАЙТИ	____________________
   1 Хромов	_
   1 Пароль	X
   1 прірву	INS
   1 режимі	24
   1 Дніпра	24
   1 серпня	2018
   1 восени	2017
   1 грудня	2013
   1 більше	2
   1 ВОЛИНЬ	1943
   1 Аккаду	05
   1 справи	04
   1 ТАБЛОID	ЖИТТЯ
   1 ютері	УВІЙТИВІДМІНИТИ
   1 ласка	зареєструйтесь
   1 Окрім	інформатизації
   1 новій	інформаційній
   1 Росії	продовжується
   1 шляхи	реформування
   1 цикли	радіопередач
   1 рівні	Укрдержархів
   1 праці	спеціалістів
   1 образ	українського
   1 інших	організацій
   1 штату	компенсація
   1 угоди	міжнародної
   1 стало	призначення
   1 після	оптимізації
   1 можна	реалізувати
   1 мають	розвиватися
   1 країн	законодавчо
   1 жоден	український
   1 умови	зберігання
   1 праці	архівістів
   1 появи	профільних
   1 мають	можливість
   1 мають	залучатися
   1 вкрай	обурливими
   1 архів	наприкінці
   1 Петро	Григоренко
   1 Копії	документів
   1 Варто	відзначити
   1 часто	жаліються
   1 цьому	залишивши
   1 уваги	більшості
   1 стати	сучасними
   1 самим	зменшуючи
   1 сайту	дозволено
   1 після	зауважень
   1 назву	Концепція
   1 ззаду	страхував
   1 груди	комуніста
   1 вчора	Інновації
   1 варто	переймати
   1 архів	Київської
   1 Музею	Голокосту
   1 чергу	найбільш
   1 факти	говорить
   1 тижні	каденції
   1 також	полюбляє
   1 сягає	максимум
   1 сфери	водночас
   1 стати	джерелом
   1 стати	гарантом
   1 стане	допомога
   1 світі	осередок
   1 своїм	акаунтом
   1 окрім	етичного
   1 облік	ведуться
   1 людей	працюють
   1 книги	архівної
   1 змогу	виводити
   1 звіти	імітуючи
   1 задум	потребує
   1 деякі	сміливці
   1 Помер	останній
   1 Пласт	скаутинг
   1 часто	плодить
   1 цьому	натовпі
   1 уваги	держави
   1 такої	реформи
   1 собою	функції
   1 рівні	архівам
   1 пошук	предків
   1 намір	описати
   1 назву	Гашомер
   1 назад	Стрибок
   1 можна	назвати
   1 менти	тиснули
   1 мають	негайно
   1 ззаду	тиснули
   1 життя	архівів
   1 давно	назріла
   1 війни	архівні
   1 важко	назвати
   1 брата	Зокрема
   1 базою	питання
   1 архів	створив
   1 ЖИТТЯ	ІСТОРІЯ
   1 Ірини	Бокової
   1 язків	Справа
   1 щодня	зжирає
   1 хтось	чудово
   1 описи	фондів
   1 одним	словом
   1 місті	Львові
   1 можна	уявити
   1 мають	заново
   1 взяло	участь
   1 бодай	когось
   1 ФОРУМ	ЄВРОПА
   1 Світу	ЮНЕСКО
   1 Логін	Пароль
   1 Деякі	архіви
   1 через	угоди
   1 цього	факту
   1 стане	базою
   1 своєю	суттю
   1 першу	чергу
   1 новий	читач
   1 мають	стати
   1 кожен	архів
   1 зобов	язана
   1 епосі	Життя
   1 дають	змогу
   1 група	людей
   1 Пласт	Однак
   1 Запам	ятати
   1 Білої	книги
   1 БЛОГИ	ФОРУМ
   1 язана	буде
   1 читач	будь
   1 цьому	комп
   1 рисах	вона
   1 мають	бути
   1 гасло	Геть
   1 вбито	усіх
   1 Окрім	того
   1 Однак	досі
   1 Коржа	Тоді
   1 Асада	Інші
   1 часто	під
   1 угоди	про
   1 пункт	але
   1 міфів	які
   1 можна	вже
   1 людей	без
   1 копії	які
   1 копії	Для
   1 есеїв	Сто
   1 базою	для
   1 Світу	був
   1 Довга	ніч
   1 ятати	на
   1 часто	на
   1 факту	як
   1 суттю	та
   1 речей	на
   1 місці	та
   1 людей	до
   1 кроки	до
   1 кризи	на
   1 Росія	не
   1 Однак	це
   1 числі	в
   1 фонду	у
   1 сфері	в
   1 кроки	є
   1 даних	А
   1 влити	в
   1 виник	і
   1 Шукай	в
   1 Життя	в
   1 Вчені	з
   1 Архів	П
   1 друку	e3be68f
   1 архів	dbd0795
   1 також	Quo
   1 ШАЛОМ	INT
   1 знято	7e176a8
   1 кінця	2017
   1 ночей	1921
   1 гетто	02
   1 тощо	Інтернаціональний
   1 язки	Застосування
   1 фонд	користування
   1 його	російського
   1 бути	впроваджено
   1 була	звинувачена
   1 буде	забезпечити
   1 Доля	українських
   1 який	відповідав
   1 роль	останнього
   1 було	можливості
   1 Світ	змінюється
   1 усіх	сільських
   1 тощо	Зростання
   1 стан	більшості
   1 риси	становища
   1 наук	заступник
   1 може	слугувати
   1 далі	продовжує
   1 вона	зводиться
   1 бути	стратегія
   1 бути	викладені
   1 язки	провести
   1 хати	завітали
   1 усіх	відділів
   1 слід	постійно
   1 року	колекція
   1 лише	загальні
   1 лайн	виставку
   1 його	сателіта
   1 було	потрібно
   1 було	знайдено
   1 була	включена
   1 акти	старшого
   1 Леся	Бондарук
   1 чого	змінити
   1 часи	агресії
   1 фонд	України
   1 того	жодного
   1 того	архівам
   1 теми	Архівні
   1 крик	дружини
   1 досі	забутим
   1 КПРС	Міхаіла
   1 яких	наразі
   1 який	хочемо
   1 того	навіть
   1 стаж	роботи
   1 року	впадає
   1 роки	тісної
   1 нові	зразки
   1 мені	відомо
   1 було	раніше
   1 Теми	архіви
   1 Крок	уперед
   1 тощо	Окрім
   1 тому	числі
   1 стан	речей
   1 роки	Росія
   1 може	стати
   1 мати	образ
   1 лайн	деякі
   1 комп	ютері
   1 коли	менти
   1 було	знято
   1 було	вбито
   1 будь	ласка
   1 Тому	гасло
   1 Мене	ззаду
   1 Інші	факти
   1 часу	коли
   1 таке	інше
   1 року	була
   1 план	лише
   1 мало	бути
   1 звіт	план
   1 були	роки
   1 Юрій	Юзич
   1 Крім	того
   1 яких	має
   1 тези	про
   1 році	все
   1 одну	ніч
   1 мене	Час
   1 віку	які
   1 будь	яка
   1 Геть	від
   1 інше	Не
   1 чому	це
   1 факт	що
   1 самі	ім
   1 ролі	та
   1 року	та
   1 року	до
   1 року	Ці
   1 року	Ми
   1 план	ця
   1 лише	на
   1 звіт	за
   1 десь	на
   1 груп	на
   1 Якщо	ви
   1 Хоча	на
   1 Отже	на
   1 Вона	як
   1 Бога	на
   1 одну	з
   1 наші	я
   1 лише	з
   1 кулю	в
   1 живе	в
   1 бази	є
   1 Тоді	в
   1 зони	WiFi
   1 Юзич	36677ef
   1 Йорк	21
   1 ПРО	ПРОЕКТЗВОРОТНІЙ
   1 про	Чорнобильську
   1 яка	неодноразово
   1 тис	користувачів
   1 під	керівництвом
   1 при	необхідності
   1 має	підтримувати
   1 для	коментування
   1 Для	користувачів
   1 яка	сканувальна
   1 яка	намагається
   1 під	переляканий
   1 для	української
   1 для	дослідників
   1 від	справжнього
   1 Для	авторизації
   1 час	руйнування
   1 про	соборність
   1 має	базуватися
   1 для	формування
   1 був	підписаний
   1 без	профільної
   1 без	постійного
   1 США	інвестицій
   1 США	Польського
   1 Без	додаткових
   1 які	складають
   1 цій	невеликій
   1 цих	локальних
   1 там	насправді
   1 сам	проводити
   1 про	співпрацю
   1 про	включення
   1 при	нагальній
   1 всі	попередні
   1 Яна	Тимошенко
   1 які	працюють
   1 яка	отримала
   1 тлі	слабкого
   1 для	інтернет
   1 для	можливої
   1 вже	зроблена
   1 але	присутні
   1 ХХІ	сторіччя
   1 Для	прикладу
   1 які	містять
   1 тих	далеких
   1 тис	установ
   1 тим	суттєво
   1 про	історію
   1 про	Бандеру
   1 має	сприяти
   1 Він	побачив
   1 так	щільно
   1 так	званої
   1 про	Євгена
   1 мій	погляд
   1 має	досвід
   1 для	оплати
   1 він	просто
   1 від	Москви
   1 все	більше
   1 вже	приніс
   1 без	різних
   1 або	масове
   1 які	часто
   1 які	дають
   1 тим	самим
   1 під	своїм
   1 має	стати
   1 маю	намір
   1 для	друку
   1 два	назад
   1 вже	взяло
   1 баз	даних
   1 США	Музею
   1 ЗМІ	цикли
   1 ніч	було
   1 має	бути
   1 від	часу
   1 Сто	слів
   1 СБУ	Доля
   1 Про	Бога
   1 Нью	Йорк
   1 під	час
   1 пам	яті
   1 Час	від
   1 яті	та
   1 які	до
   1 яка	за
   1 хто	за
   1 теж	не
   1 рік	На
   1 вже	як
   1 але	не
   1 або	як
   1 Він	не
   1 Всі	ці
   1 яті	і
   1 ніч	з
   1 для	FamilySearch
   1 на	загальноукраїнському
   1 та	розповсюдження
   1 та	реставраційних
   1 та	культурницьких
   1 чи	архівознавчої
   1 та	репрезентації
   1 та	національними
   1 та	краудсорсингу
   1 та	запровадження
   1 та	обговорювати
   1 та	недосконалої
   1 На	міжнародному
   1 що	керівництво
   1 ще	залишається
   1 та	центральних
   1 та	український
   1 та	телепередач
   1 та	національні
   1 та	міжнародним
   1 та	аутсорсингу
   1 не	забезпечені
   1 на	дослідження
   1 на	Українській
   1 де	користувачі
   1 На	Прикарпатті
   1 ЗВ	ЯЗОКРЕКЛАМА
   1 як	дослідники
   1 що	інформація
   1 що	сертифікат
   1 це	ініціатива
   1 це	мавпування
   1 це	досягнення
   1 та	пропозицій
   1 та	паритетною
   1 та	нормативні
   1 та	збільшення
   1 та	директорів
   1 за	ініціативи
   1 за	паперовими
   1 за	невеликими
   1 за	важливістю
   1 до	індексації
   1 до	поліпшення
   1 до	документів
   1 Не	відкидаючи
   1 НА	САЙТІАРХІВ
   1 її	прикладом
   1 як	польський
   1 що	корисного
   1 що	концепція
   1 ще	актуально
   1 це	закупівля
   1 та	іноземних
   1 та	цинічними
   1 та	створення
   1 та	одночасно
   1 та	архівісти
   1 не	працювали
   1 не	матєрілся
   1 не	зрозуміло
   1 не	вигукував
   1 на	співпрацю
   1 на	противагу
   1 на	периферії
   1 на	отримання
   1 на	Історичну
   1 за	ідеологію
   1 за	прикладом
   1 як	справжні
   1 що	майбутні
   1 ці	принципи
   1 ця	ситуація
   1 ця	паперова
   1 та	створити
   1 та	передача
   1 та	архівної
   1 не	останній
   1 не	заважати
   1 на	практиці
   1 за	потрібне
   1 за	окремими
   1 до	проектів
   1 до	вбивства
   1 як	приклад
   1 як	правило
   1 як	Україна
   1 це	принцип
   1 та	програм
   1 та	окремих
   1 не	завдяки
   1 на	першому
   1 на	керівні
   1 на	Фейсбук
   1 на	Майдані
   1 зі	стійким
   1 за	рахунок
   1 за	першими
   1 до	архівів
   1 На	початку
   1 На	порядок
   1 із	пошуку
   1 як	єдиний
   1 як	мантру
   1 що	навіть
   1 що	зомлію
   1 що	восени
   1 цю	довіру
   1 це	більше
   1 ті	заходи
   1 та	онлайн
   1 та	обліку
   1 та	навіть
   1 та	зручні
   1 по	голові
   1 не	тільки
   1 не	вважає
   1 на	стадії
   1 на	посаді
   1 на	перший
   1 на	одного
   1 на	кшталт
   1 на	вулицю
   1 на	архіви
   1 за	спиною
   1 за	лічені
   1 до	такого
   1 до	однієї
   1 Ми	стояли
   1 Ви	можете
   1 ще	вчора
   1 чи	копії
   1 чи	варто
   1 це	часто
   1 та	інших
   1 та	шляхи
   1 та	часто
   1 та	облік
   1 не	можна
   1 на	цьому
   1 зв	язків
   1 за	собою
   1 за	своєю
   1 до	цього
   1 до	появи
   1 ви	новий
   1 бо	окрім
   1 що	мало
   1 це	мати
   1 це	лише
   1 це	було
   1 ті	самі
   1 та	живе
   1 не	може
   1 на	яких
   1 на	тези
   1 на	стан
   1 до	хати
   1 до	того
   1 ЦК	КПРС
   1 як	вже
   1 що	там
   1 що	вже
   1 на	тлі
   1 на	рік
   1 на	мій
   1 зі	ЗМІ
   1 де	вже
   1 як	це
   1 як	до
   1 що	не
   1 це	те
   1 та	як
   1 та	зв
   1 та	за
   1 не	те
   1 на	це
   1 де	як
   1 їм	в
   1 ім	я
   1 що	і
   1 що	у
   1 що	в
   1 до	30
   1 на	11
   1 і	малодослідженим
   1 в	інформаційному
   1 і	невмотивовані
   1 у	європейський
   1 у	Варшавському
   1 а	Укрдержархів
   1 і	температури
   1 і	переповнені
   1 і	максимально
   1 р	Керівництво
   1 і	тематичних
   1 є	унікальною
   1 є	нормальною
   1 р	Незважаючи
   1 з	системними
   1 з	посиланням
   1 ж	Фотографія
   1 в	українську
   1 і	фактичної
   1 і	наскільки
   1 у	секретаря
   1 у	підтримці
   1 у	відкритий
   1 з	Січеслава
   1 в	найкращих
   1 в	Європіані
   1 В	загальних
   1 І	спровокує
   1 І	дозволять
   1 і	виходила
   1 і	апелюють
   1 є	частиною
   1 є	приклади
   1 є	кризовий
   1 у	місячний
   1 з	римської
   1 з	окремими
   1 з	головних
   1 з	архівами
   1 в	сучасних
   1 в	нинішніх
   1 в	багатьох
   1 в	Інтернет
   1 Ю	ГОЛОКОСТ
   1 В	ятровичу
   1 А	покарати
   1 і	відомий
   1 у	ракурсі
   1 у	пошуках
   1 у	вільний
   1 р	Подібні
   1 р	Близько
   1 з	ясували
   1 з	бюджету
   1 в	частині
   1 в	форматі
   1 в	столиці
   1 в	останні
   1 в	окремих
   1 А	держава
   1 і	перший
   1 і	пароль
   1 і	жіноча
   1 і	більше
   1 є	цінним
   1 я	навіть
   1 у	царині
   1 у	прірву
   1 в	ідеалі
   1 в	старих
   1 в	режимі
   1 в	орбіті
   1 а	штатні
   1 В	умовах
   1 В	Путіна
   1 і	Пласт
   1 є	вкрай
   1 у	цьому
   1 у	місті
   1 р	Варто
   1 в	цьому
   1 в	світі
   1 в	першу
   1 в	новій
   1 в	груди
   1 в	Росії
   1 а	часто
   1 а	після
   1 Б	Асада
   1 і	таке
   1 в	чому
   1 в	часи
   1 в	одну
   1 В	одну
   1 І	Вона
   1 і	тим
   1 і	під
   1 і	для
   1 з	тих
   1 в	цій
   1 І	або
   1 і	це
   1 і	не
   1 А	не
   1 І	це
   1 І	не
   1 і	у
   1 я	і
   1 а	в
   1 І	В
   1 в	2018
   1 з	10
   1 vadis	Крок
   1 png	Twitter
   1 png	Facebook
   1 kipiani	jpg
   1 jpg	Загальновідомо
   1 jpg	Оцифрування
   1 jpg	Анатолій
   1 jpg	Вахтанг
   1 jpg	Валерій
   1 jpg	Архівна
   1 jpg	60
   1 ico02	png
   1 ico01	png
   1 e3be68f	135
   1 e369730	1
   1 digitalarchives	цифрові
   1 dbd0795	4
   1 adc6f43	4
   1 ____________________	Українська
   1 _	Понеділок
   1 _	Вахтанг
   1 _	Юрій
   1 _	Леся
   1 _	Яна
   1 X	Запам
   1 WiFi	банківські
   1 Twitter	
   1 RSS	ЗНАЙТИ
   1 Quo	vadis
   1 L	INS
   1 INT	L
   1 INS	Коротко
   1 INS	ТАБЛОID
   1 INS	Теми
   1 INS	П
   1 FamilySearch	США
   1 Facebook	ico02
   1 8899	jpg
   1 7e807325	kipiani
   1 7e176a8	123
   1 7da92b6	3
   1 75b471b	7e807325
   1 72d0794	8899
   1 7	мобільні
   1 60	Тамара
   1 60	215
   1 5	а
   1 47	Посольство
   1 43	2010
   1 4	jpg
   1 4	0
   1 36677ef	137
   1 30	тис
   1 3	роки
   1 3	jpg
   1 28	12
   1 2663586	2
   1 25	12
   1 24	7
   1 24	12
   1 22	Версія
   1 215	60
   1 21	століття
   1 21	12
   1 2018	Українська
   1 2018	році
   1 2018	року
   1 2018	15
   1 2013	року
   1 2010	2018
   1 20	серпня
   1 2	тис
   1 2	jpg
   1 1986	року
   1 1943	КАНАДІАНА
   1 1921	року
   1 19	На
   1 15	22
   1 137	jpg
   1 135	jpg
   1 123	jpg
   1 11	грудня
   1 100	РЕФОРМАЦІЯ
   1 10	на
   1 1	jpg
   1 07	Вінницький
   1 05	19
   1 05	07
   1 04	47
   1 04	00
   1 02	43
   1 00	Помер
   1 0	jpg
