   6 не	було
   6 1918	році
   6 1918	року
   5 відповідальність	за
   5 тих	хто
   5 в	умовах
   5 у	Києві
   5 у	2014
   4 українська	незалежність
   4 державних	інституцій
   4 століття	тому
   4 бійся	борись
   4 до	державних
   4 і	не
   4 у	1918
   4 У	1918
   4 2014	року
   4 1917	року
   3 листопада	1918
   3 залежить	від
   3 українці	не
   3 Недовіра	до
   3 цілого	суспільства
   3 живуть	залежить
   3 готові	брати
   3 брати	відповідальність
   3 вони	живуть
   3 своє	життя
   3 може	бути
   3 без	столиці
   3 до	кінця
   3 до	влади
   3 як	вони
   3 за	своє
   3 що	те
   3 те	як
   3 Це	ще
   3 2014	році
   3 1918	го
   2 тоталітарного	минулого
   2 демобілізацію	солдатам
   2 інформаційної	війни
   2 українського	суспільства
   2 незалежність	вистояла
   2 незалежність	не
   2 української	республіки
   2 суспільства	вибирає
   2 Центральної	Ради
   2 стверджують	що
   2 Четвертого	Універсалу
   2 Українська	республіка
   2 Українська	Республіка
   2 російської	агресії
   2 київському	Майдані
   2 негативний	досвід
   2 соціології	НАНУ
   2 позитивних	змін
   2 Центральна	Рада
   2 українців	стверджують
   2 Четвертий	Універсал
   2 зовнішніх	обставин
   2 Олександр	Зінченко
   2 російська	агресія
   2 листопада	1917
   2 Інститут	соціології
   2 світової	війни
   2 минулого	Але
   2 вплинули	на
   2 Частина	суспільства
   2 Віталій	Скальський
   2 кількох	відсотків
   2 складні	питання
   2 глибини	власної
   2 власної	кишені
   2 десятки	тисяч
   2 воєнний	стан
   2 країною	без
   2 Євгена	Чикаленка
   2 змогла	вистояти
   2 борись	Чому
   2 однією	з
   2 грудня	У
   2 Павло	Скоропадський
   2 сотні	тисяч
   2 років	щоб
   2 життя	Це
   2 січня	2014
   2 січні	1918
   2 який	підтримував
   2 Чому	українська
   2 свої	проблеми
   2 була	країною
   2 тими	самими
   2 чому	тепер
   2 чому	тоді
   2 тоді	коли
   2 було	кому
   2 тому	що
   2 року	на
   2 тоді	і
   2 році	в
   2 від	зовнішніх
   2 цих	кількох
   2 них	самих
   2 ять	про
   2 пам	ять
   2 від	них
   2 або	не
   2 на	київському
   2 не	видержить
   2 на	українців
   2 не	вистояла
   2 що	Україна
   2 це	питання
   2 не	вдалося
   2 на	складні
   2 до	глибини
   2 не	тільки
   2 не	змогла
   2 не	бійся
   2 Не	бійся
   2 ще	один
   2 по	собі
   2 як	на
   2 що	не
   2 те	що
   2 не	до
   2 з	ясувалося
   2 з	найбільш
   2 в	Україні
   2 є	однією
   2 у	січні
   2 У	Києві
   2 і	чому
   2 в	тому
   2 з	тих
   2 і	в
   2 jpg	Віталій
   2 e5c754f	60
   2 60	jpg
   2 2014	му
   2 20	листопада
   2 1918	му
   2 1917	го
   2 15	листопада
   2 14	15
   1 ТЕКСТИКОРОТКОКНИЖКИАРТЕФАКТИКОЛОНКИВІДЕОДАЙДЖЕСТІНТЕРВ	ЮСТУДІЇКАЛЕНДАРЕ
   1 ультрапопулістськими	гаслами
   1 середньотерміновій	перспективі
   1 КСКУРСІЇБЛОГОСФЕРА	
   1 інтернаціоналісти	af527f4
   1 ЮСТУДІЇКАЛЕНДАРЕ	КСКУРСІЇБЛОГОСФЕРА
   1 макроекономічної	стабілізації
   1 ультрапопулізмом	більшовиків
   1 нонконформістами	діалектика
   1 патерналістичній	більшості
   1 відповідальності	цілого
   1 відповідальність	на
   1 ультрапопулізму	більшовиків
   1 посттоталітарні	комплекси
   1 постколоніальні	комплекси
   1 Постколоніальні	комплекси
   1 катастрофічного	сценарію
   1 відрефлексувало	методи
   1 відбуватиметься	реванш
   1 Позаекономічний	примус
   1 персоналізувати	свої
   1 демілітарізації	сама
   1 запроваджується	не
   1 громадянськості	до
   1 ПРОЕКТЗВОРОТНІЙ	ЗВ
   1 Посттоталітарні	і
   1 землевласників	Карикатуристи
   1 неспроможність	суспільство
   1 деморалізовану	небоєздатну
   1 Соціалістичний	експеримент
   1 поміркованіший	порівнюючи
   1 неспроможність	поступово
   1 більшовицького	повстання
   1 ультрапопулізм	Українці
   1 компенсаторною	реакцією
   1 відповідальних	громадян
   1 переосмисленню	досвіду
   1 мобілізовувала	активну
   1 Скоропадському	Прийшов
   1 популістськими	ідеями
   1 ненасильницькі	масові
   1 півмільйонному	Києві
   1 бездержавності	Влада
   1 землевласників	який
   1 протилежностей	що
   1 перетворюється	на
   1 пересмикування	це
   1 землевласників	не
   1 відтворюватися	в
   1 відсиджувалися	в
   1 Републікується	з
   1 опублікований	Українським
   1 деморалізації	суспільства
   1 гетьманського	перевороту
   1 Скоропадський	запровадив
   1 Правительство	Республіки
   1 саморегуляція	економіки
   1 популістським	Четвертим
   1 позапартійних	депутатів
   1 комнезамівців	Причетних
   1 відпрацьовані	російська
   1 самостійності	загрожує
   1 відповідальна	меншість
   1 Мефодіївської	гімназії
   1 сьогоднішньої	України
   1 промисловість	держави
   1 запроваджував	Воєнний
   1 гіперінфляцію	досягти
   1 вільноринкові	реформи
   1 більшовицької	агресії
   1 Скоропадський	Петлюра
   1 прогулювалися	міщани
   1 популістських	гаслах
   1 Скоропадський	Довіра
   1 Всеросійський	список
   1 інформаційній	війні
   1 українізовані	полки
   1 самотворчості	Вона
   1 маніфестувати	інші
   1 землевоасника	який
   1 звинувачувати	тих
   1 Скоропадський	від
   1 самостійності	до
   1 проголосувала	за
   1 перетворилися	на
   1 деморалізація	і
   1 Скоропадський	у
   1 Карикатуристи	у
   1 Запобіжником	катастрофічного
   1 прихильність	землевласників
   1 Сагайдачного	відсиджувалися
   1 Винниченкові	Грушевському
   1 українському	суспільству
   1 соціологічна	реальність
   1 самостійного	державного
   1 проголошення	Четвертого
   1 прихильність	селянської
   1 забезпечення	скалічених
   1 незалежність	підкладав
   1 незалежності	оголосили
   1 незалежності	виступило
   1 економічного	зростання
   1 демонстрацію	студентів
   1 Грушевського	буквально
   1 незалежність	століття
   1 Усвідомлення	спільної
   1 Грушевського	праворуч
   1 українського	Майдану
   1 статистичної	похибки
   1 Університету	Святого
   1 Грушевського	вважали
   1 незалежність	доволі
   1 диктаторські	закони
   1 Грушевському	ганьба
   1 українського	уряду
   1 революційних	подій
   1 меморіальної	дошки
   1 господарське	життя
   1 Соціалізація	землі
   1 Півмільйонне	місто
   1 Незалежність	Тепер
   1 компенсувати	свою
   1 добровольців	було
   1 підтверджена	тим
   1 прозвітувало	про
   1 відрізнятися	від
   1 сприймаються	як
   1 розраховував	на
   1 незалежності	Ця
   1 конформістів	на
   1 досліджувати	як
   1 випробування	на
   1 Солідарність	чи
   1 Грушевському	та
   1 стабілізації	і
   1 стабільності	а
   1 спостерігало	і
   1 незалежність	у
   1 незалежність	а
   1 народжуються	і
   1 Незалежності	у
   1 Сріблянський	20
   1 демонстрації	1917
   1 конкуренцію	ультрапопулізму
   1 оголошувати	демобілізацію
   1 української	незалежності
   1 суспільство	Усвідомлення
   1 проголосила	незалежність
   1 української	перспективи
   1 самостійним	економічним
   1 підтримував	український
   1 політичними	небезпеками
   1 перспективі	розстріляли
   1 мобілізацію	Символічний
   1 конформісти	боятимуться
   1 Української	Центральної
   1 Студентські	заворушення
   1 підтримував	українську
   1 протистоїть	конформній
   1 полковником	Болбочаном
   1 поведінкові	стереотипи
   1 залишається	стабільним
   1 залишаються	незмінними
   1 експеримент	закінчився
   1 гавелівська	Оксамитова
   1 виявляється	українське
   1 Української	республіки
   1 Поведінкові	стереотипи
   1 українських	меценатів
   1 представник	меншостей
   1 нетерплячої	більшості
   1 залишаються	потужними
   1 американців	Українцям
   1 Української	революції
   1 Прикарпатті	оголосили
   1 суспільству	Популізм
   1 суспільства	тривалою
   1 самостійній	Народній
   1 необхідними	знаннями
   1 майбутньому	Зазвичай
   1 забезпечили	перемогу
   1 більшовиків	захищати
   1 більшовиків	Недовіра
   1 Універсалом	означала
   1 Українським	журналом
   1 Конформісти	вступили
   1 фотогалереї	Колонки
   1 суспільства	Минають
   1 пограбована	Перейти
   1 економічним	змістом
   1 державність	встояла
   1 більшовиків	Україна
   1 Українській	Державі
   1 Символічний	мільйон
   1 суспільство	значно
   1 суспільства	Лідери
   1 неприродний	відбір
   1 небезпечних	загроз
   1 економічним	життям
   1 суспільства	після
   1 регулюється	через
   1 привабливим	серед
   1 осцилографі	після
   1 небоєздатну	армію
   1 знадобилося	майже
   1 більшовикам	Крути
   1 ФОТОГАЛЕРЕЇ	ВІДЕО
   1 Грушевський	після
   1 розстріляли	всіх
   1 прокламації	може
   1 переляканий	крик
   1 боятимуться	ідей
   1 Центральній	Раді
   1 український	рух
   1 суспільства	Але
   1 небезпеками	Але
   1 конформісти	наш
   1 керівництві	УНР
   1 керівництво	УНР
   1 керівництва	УНР
   1 застережені	ПРО
   1 відмовилося	від
   1 більшовиків	Усі
   1 Універсалом	Він
   1 Грушевський	УНР
   1 суспільство	не
   1 суспільство	де
   1 суспільства	ті
   1 суспільства	за
   1 сподіватися	що
   1 розпадалась	на
   1 потерпівших	од
   1 перекладати	цю
   1 перевищують	за
   1 небезпечний	Це
   1 наближалась	до
   1 майбутньому	це
   1 конкурувати	із
   1 впевненість	що
   1 висовувайся	та
   1 випробувань	що
   1 більшовиків	чи
   1 ЯЗОКРЕКЛАМА	НА
   1 Повернутися	до
   1 перспективи	в
   1 коливаються	в
   1 застосовані	у
   1 громадянина	У
   1 відбувалася	в
   1 визначилися	З
   1 економічній	300
   1 заворушення	14
   1 Знадобилося	10
   1 САЙТІАРХІВ	ТЕКСТИКОРОТКОКНИЖКИАРТЕФАКТИКОЛОНКИВІДЕОДАЙДЖЕСТІНТЕРВ
   1 конформній	патерналістичній
   1 століттями	бездержавності
   1 присвячене	переосмисленню
   1 економічну	неспроможність
   1 економікою	Соціалістичний
   1 Захоплення	популістськими
   1 ініціативи	самотворчості
   1 реальність	сьогоднішньої
   1 оголошення	самостійності
   1 Хрещатиком	прогулювалися
   1 українську	незалежність
   1 радикально	відрізнятися
   1 налагодити	господарське
   1 Українську	незалежність
   1 українське	суспільство
   1 українська	державність
   1 ефективним	суспільство
   1 Універсалу	економічним
   1 Скальський	Студентські
   1 Вогнехреща	Конформісти
   1 інституцій	змінюються
   1 робітників	Українську
   1 республіка	Українська
   1 популістам	економічну
   1 змінюються	президенти
   1 завершення	Четвертний
   1 демократію	Конформізм
   1 декларації	Четвертого
   1 Українську	Центральну
   1 Українська	Центральна
   1 Нахманович	російський
   1 помешканні	студенток
   1 насамперед	спробуймо
   1 аморальної	більшості
   1 абсолютній	більшості
   1 Українська	революція
   1 Оксамитова	революція
   1 Конформізм	більшості
   1 імперським	анклавом
   1 сьогодення	популізм
   1 спрощувала	завдання
   1 свідомості	багатьох
   1 позитивним	досвідом
   1 пересічний	виборець
   1 отримувала	навзамін
   1 особистими	якостями
   1 огіївських	пиріжків
   1 найбільшої	світової
   1 елементами	еволюції
   1 встановити	контроль
   1 американці	Політика
   1 селянської	верстви
   1 російський	Титанік
   1 радянської	анексії
   1 політичних	режимів
   1 найближчих	виборах
   1 запровадив	воєнний
   1 закінчився	голодом
   1 діалектика	єдність
   1 банківську	систему
   1 Хрещатиком	навесні
   1 Українська	Народна
   1 Республіці	України
   1 Республіка	вимагає
   1 Клаптикова	імперія
   1 цілковитий	розпад
   1 українські	партії
   1 стереотипи	здатні
   1 сповнилося	велике
   1 республіки	мусили
   1 радикально	змінив
   1 напруженої	роботи
   1 готовність	фільму
   1 Установчих	зборів
   1 Українська	правда
   1 Негативний	досвід
   1 розпустити	армію
   1 республіку	часто
   1 радянських	часів
   1 паралельні	прямі
   1 опиняємося	перед
   1 ольгінські	тролі
   1 карикатури	легко
   1 загального	рівня
   1 державного	життя
   1 безробітні	могли
   1 активності	вищої
   1 РЕФОРМАЦІЯ	ШАЛОМ
   1 інституцій	тоді
   1 усвідомити	свою
   1 українську	ідею
   1 стереотипи	коли
   1 свідченням	того
   1 республіки	була
   1 республіка	була
   1 підписання	Комп
   1 пробуджена	Того
   1 президенти	люди
   1 можливості	возз
   1 Четвертний	союз
   1 Центральну	Раду
   1 Республіка	була
   1 Голодомору	були
   1 Володимира	Тоді
   1 Болбочаном	ФОТО
   1 фінансував	тих
   1 усвідомити	Час
   1 розпустити	Але
   1 поколіннях	які
   1 економічну	суб
   1 встановити	мир
   1 автомобілі	Усі
   1 Республіки	має
   1 Винниченка	був
   1 інституції	не
   1 інституцій	та
   1 усвідомили	що
   1 стійкішими	до
   1 стабільним	як
   1 скалічених	та
   1 розпастися	по
   1 республіки	Де
   1 республіка	Де
   1 публікацій	по
   1 протиріччя	із
   1 проголошую	чи
   1 популістів	на
   1 повторював	іх
   1 опитування	ці
   1 опитування	до
   1 незмінними	Це
   1 напоролася	на
   1 нагадувала	те
   1 зупинилося	Не
   1 декларації	чи
   1 відповідей	на
   1 більшовики	на
   1 большевики	не
   1 Скальський	Як
   1 Республіка	це
   1 Голодомору	та
   1 інструмент	у
   1 інституцій	є
   1 чемпіонами	з
   1 спекуляція	і
   1 реальності	В
   1 порівнюючи	з
   1 перевороту	в
   1 карнавалом	у
   1 заіснувала	в
   1 економічно	й
   1 демократії	з
   1 втручалося	в
   1 більшовики	і
   1 большевики	і
   1 Януковичем	У
   1 Кієвлянінъ	у
   1 Вогнехреща	в
   1 зустрічали	INS
   1 Універсалу	25
   1 соборність	05
   1 українців	Постколоніальні
   1 диктатуру	Позаекономічний
   1 революції	Републікується
   1 поступово	перетворюється
   1 сільських	комнезамівців
   1 російсько	більшовицької
   1 жахіттями	тоталітарного
   1 більшість	проголосувала
   1 Цілковита	деморалізація
   1 Гетьманат	Скоропадський
   1 Водохреща	перетворилися
   1 українцям	незалежності
   1 розганяла	демонстрацію
   1 дійсність	українського
   1 втрачаючи	прихильність
   1 велелюдні	демонстрації
   1 суспільну	мобілізацію
   1 показники	коливаються
   1 одночасно	оголошувати
   1 комплекси	залишаються
   1 зростання	Знадобилося
   1 засідання	Української
   1 Четвертим	Універсалом
   1 Львівщині	відмовилося
   1 Виживають	конформісти
   1 очікували	підписання
   1 наповнити	декларації
   1 керування	економікою
   1 заявляємо	большевики
   1 залишався	імперським
   1 відповіла	карнавалом
   1 відновити	економічну
   1 виявилися	стійкішими
   1 Універсал	проголошую
   1 спробуймо	зрозуміти
   1 революція	Гетьманат
   1 потужними	викликами
   1 оголосити	Універсал
   1 меншостей	Костянтин
   1 кількості	українців
   1 зрозуміти	відповіді
   1 виявилося	достатньо
   1 вихований	жахіттями
   1 більшість	українців
   1 більшість	злякалася
   1 Неможливо	одночасно
   1 Конформна	більшість
   1 КАНАДІАНА	РЕВОЛЮЦІЯ
   1 Володимир	Охримович
   1 фінансова	політика
   1 пролунали	постріли
   1 правилами	активної
   1 порожньою	тарілкою
   1 негативно	вплинули
   1 начитався	розумних
   1 культурно	винищена
   1 збудилася	окрадена
   1 відстояти	Популізм
   1 більшість	купилася
   1 більшості	українці
   1 Чикаленка	відомого
   1 Популісти	вирішили
   1 Полковник	Всеволод
   1 Ліксандри	вдаривши
   1 Київській	губернії
   1 ЕКОНОМІКА	ПОЛІТИКА
   1 студенток	Суличич
   1 революції	зростає
   1 половиною	місяців
   1 особистої	свободи
   1 одночасно	скільки
   1 оголосили	хорвати
   1 оголосили	конкурс
   1 київський	історик
   1 диктатури	Соляний
   1 актуальна	щоденна
   1 Українцям	допоміг
   1 Костянтин	Сухових
   1 Запоріжжі	малюють
   1 розпочати	творчу
   1 підривало	довіру
   1 пророцтво	батька
   1 освічених	верств
   1 комуніста	Дмитра
   1 київської	Кирило
   1 київський	Майдан
   1 завершили	роботу
   1 жартувала	газета
   1 депутатів	Справа
   1 витримала	Першої
   1 Чикаленка	одного
   1 Універсал	обіцяв
   1 ГОЛОДОМОР	ВОЛИНЬ
   1 Більшість	хотіла
   1 Історична	правда
   1 Історична	Правда
   1 частинами	своїх
   1 хлопчиків	фейки
   1 українців	Треба
   1 проминули	перед
   1 комплекси	тепер
   1 добробати	тепер
   1 відсотків	тепер
   1 внаслідок	війни
   1 виживання	Гумор
   1 видержить	чужої
   1 більшості	Євген
   1 Універсал	Треба
   1 українцям	одні
   1 прикласти	свої
   1 позначені	тими
   1 обмеження	прав
   1 коштувала	тоді
   1 комплекси	тоді
   1 зрозуміти	чому
   1 запитання	Одне
   1 журналіст	Київ
   1 відповідь	чому
   1 виступило	десь
   1 випустили	кулю
   1 ясувалося	він
   1 українців	ніж
   1 українців	Але
   1 стрільців	УГА
   1 революція	усі
   1 підкладав	під
   1 приблизно	так
   1 поздували	пил
   1 економіки	яка
   1 достатньо	щоб
   1 відсотків	тих
   1 втомилися	від
   1 вичікуючи	чия
   1 висовуйся	або
   1 викликами	для
   1 більшість	тим
   1 більшості	іще
   1 більшості	був
   1 ясувалося	що
   1 федерації	Як
   1 українців	як
   1 українців	На
   1 українцям	не
   1 студентів	що
   1 свідомими	що
   1 приходять	до
   1 прикладом	по
   1 прагнення	до
   1 напоровся	на
   1 намагався	ні
   1 коштувало	не
   1 комплекси	це
   1 збудилася	до
   1 глузували	із
   1 відповіді	на
   1 відповідь	на
   1 власність	на
   1 викликами	що
   1 видержить	її
   1 більшості	Ця
   1 буквально	на
   1 Троцького	та
   1 Рашатудей	та
   1 Причетних	до
   1 існування	в
   1 українців	в
   1 революції	і
   1 повстання	у
   1 найбільші	в
   1 меценатів	і
   1 методичок	і
   1 касується	П
   1 каструлях	і
   1 злякалася	і
   1 збудилася	в
   1 диктатуру	а
   1 большевик	і
   1 Універсал	у
   1 фельєтоні	IV
   1 Хронікери	5161a26
   1 Приблизно	50
   1 Приблизно	20
   1 Охримович	20
   1 листопаді	1918
   1 РЕВОЛЮЦІЯ	100
   1 МАТЕРІАЛИ	0
   1 спільної	відповідальності
   1 помітною	компенсаторною
   1 верствою	землевласників
   1 подолати	гіперінфляцію
   1 зручніше	звинувачувати
   1 сьогодні	Запобіжником
   1 реакцією	конформістів
   1 польська	Солідарність
   1 обіцянки	стабільності
   1 навзамін	прихильність
   1 меншість	українського
   1 державну	незалежність
   1 Держкіно	прозвітувало
   1 популізм	небезпечний
   1 популізм	керівництва
   1 найбільш	небезпечних
   1 минулого	виявляється
   1 минулого	Поведінкові
   1 загрожує	політичними
   1 завдання	більшовикам
   1 багатьом	поведінкові
   1 Угорщина	розпадалась
   1 язковими	елементами
   1 сценарії	радянської
   1 простіше	розпустити
   1 перемоги	популістів
   1 окрадена	економічно
   1 місцевих	робітників
   1 еволюції	політичних
   1 державні	інституції
   1 втратити	демократію
   1 вихована	століттями
   1 Популізм	Винниченка
   1 Народній	Республіці
   1 цвинтарі	Приблизно
   1 українці	виявилися
   1 спочатку	диктатуру
   1 світової	Популісти
   1 розуміли	Четвертий
   1 казармах	вичікуючи
   1 захищати	Цілковита
   1 зазвичай	позначені
   1 Приватна	власність
   1 ГОЛОКОСТ	ГОЛОДОМОР
   1 українці	втратили
   1 травмами	минулого
   1 постріли	Державна
   1 популізм	Популізм
   1 отримала	спочатку
   1 означала	вступити
   1 минулого	вплинули
   1 зібранню	незручні
   1 завітали	невідомі
   1 диктують	багатьом
   1 дивитися	Здається
   1 відомого	мецената
   1 втратили	державну
   1 виконати	обіцянки
   1 багатьох	випадках
   1 активної	меншості
   1 активною	меншістю
   1 Проблема	полягала
   1 Крістапс	Бахманіс
   1 Головаха	Інститут
   1 єнського	перемир
   1 єктність	України
   1 трудящий	чоловік
   1 тарілкою	Михайло
   1 створити	народну
   1 сміятися	замість
   1 рівність	Мартіна
   1 проблеми	замість
   1 політика	молодої
   1 платіжну	систему
   1 незручні	питання
   1 найбільш	відомих
   1 майданах	вирують
   1 знайомий	генетик
   1 захищало	четверо
   1 запитань	звучить
   1 губернії	виграли
   1 боротися	замість
   1 багнетів	вірного
   1 Українці	схильні
   1 Сценарій	анексії
   1 Зінченко	Історик
   1 Західної	України
   1 Гітлером	Путіним
   1 тривалою	війною
   1 створити	власну
   1 спільний	виклик
   1 солдатам	кінець
   1 середній	рівень
   1 розумних	книжок
   1 помилках	значно
   1 освітнім	рівнем
   1 зазвичай	тільки
   1 вистояти	Яценюк
   1 активної	меншос
   1 Українці	румуни
   1 Здається	других
   1 Зазвичай	лідери
   1 ДАЙДЖЕСТ	ІНТЕРВ
   1 Всеволод	Петрів
   1 Архипчук	Справа
   1 сценарію	тепер
   1 потужний	фугас
   1 покарати	бодай
   1 опертися	внизу
   1 обставин	Решта
   1 загрозою	чимсь
   1 вільного	ринку
   1 виходить	булат
   1 виходили	сотні
   1 вистояла	після
   1 багатьох	влада
   1 Холодної	війни
   1 Українці	стали
   1 Державна	варта
   1 словенці	чехи
   1 провести	сякі
   1 проблема	коли
   1 недовіра	була
   1 меншість	буде
   1 латишами	вони
   1 зберегти	свою
   1 залежить	ваше
   1 друкують	хіба
   1 досвідом	Факт
   1 вистояти	тоді
   1 вистояла	Тоді
   1 виданням	Ґедз
   1 Політика	розп
   1 сьогодні	Цей
   1 ситуацію	так
   1 синоніми	Але
   1 перемогу	Іще
   1 меншістю	тим
   1 коритися	так
   1 контроль	над
   1 знаннями	щоб
   1 захищало	дві
   1 загрозою	для
   1 громадян	хто
   1 відсоток	тих
   1 вмирають	Але
   1 вважаєте	від
   1 активних	дій
   1 Ресурсів	для
   1 Популізм	щоб
   1 якостями	та
   1 сьогодні	ми
   1 столітті	Не
   1 синергію	із
   1 редакції	УЖ
   1 проблеми	не
   1 праворуч	та
   1 перевага	на
   1 обставин	чи
   1 недовіри	до
   1 написано	що
   1 минулого	як
   1 меншості	На
   1 купилася	на
   1 захищати	не
   1 забувати	що
   1 гімназії	та
   1 вплинути	на
   1 вирішили	що
   1 випадках	не
   1 виглядає	як
   1 виборець	не
   1 вдаривши	її
   1 вважають	що
   1 вбивства	не
   1 анклавом	На
   1 Шевченка	та
   1 Троцький	та
   1 Арсеналі	та
   1 єднатися	з
   1 черкесці	з
   1 солдатам	і
   1 сильними	є
   1 проблеми	У
   1 полягала	в
   1 пиріжків	В
   1 обіцянки	І
   1 невідомі	і
   1 минулого	і
   1 мецената	і
   1 кинжалом	і
   1 знайдено	А
   1 загрозою	з
   1 журналом	у
   1 вступити	у
   1 вступили	у
   1 вистояла	і
   1 вистояла	у
   1 винищена	й
   1 Турчинов	і
   1 Популізм	У
   1 Білорусі	у
   1 потрібно	e5c754f
   1 Зінченко	_
   1 Популізм	VS
   1 ПОЛІТИКА	RSS
   1 Бахманіс	27
   1 Вівторок	22
   1 досягти	макроекономічної
   1 схильні	персоналізувати
   1 Україні	запроваджується
   1 єдність	протилежностей
   1 людства	ненасильницькі
   1 чоловік	Правительство
   1 селянам	демобілізацію
   1 підняти	промисловість
   1 гетьман	Скоропадський
   1 активна	відповідальна
   1 звучало	Грушевському
   1 досягти	економічного
   1 війська	Півмільйонне
   1 вдалося	Винниченкові
   1 байдуже	спостерігало
   1 айсберг	українського
   1 Михайлв	Грушевського
   1 частину	суспільства
   1 молодої	української
   1 досвіду	Української
   1 вірного	Центральній
   1 відомих	українських
   1 володіє	необхідними
   1 агресія	відбувалася
   1 Україна	проголосила
   1 Питання	української
   1 Михайло	Грушевський
   1 швидких	позитивних
   1 столиці	Українська
   1 складно	налагодити
   1 простих	відповідей
   1 прийшли	більшовики
   1 початку	російської
   1 мислимо	встановити
   1 красиві	декларації
   1 знищили	українську
   1 закидав	популістам
   1 допоміг	негативний
   1 геноцид	Голодомору
   1 виграли	українські
   1 Україна	заіснувала
   1 Святого	Володимира
   1 Народна	Республіка
   1 Віталій	Нахманович
   1 щоденна	дійсність
   1 ставить	українцям
   1 свободи	українців
   1 першими	Виживають
   1 найменш	освічених
   1 звучить	приблизно
   1 дружини	Ліксандри
   1 досвіду	існування
   1 гаслами	Троцького
   1 вирують	революції
   1 більшої	кількості
   1 Україна	збудилася
   1 Титанік	напоровся
   1 Останнє	засідання
   1 Минають	революції
   1 Історик	журналіст
   1 хорвати	словенці
   1 справою	активної
   1 систему	подолати
   1 реформи	створити
   1 нагадує	сценарії
   1 методів	активних
   1 змістом	Ресурсів
   1 замість	коритися
   1 задавав	зібранню
   1 загроза	перемоги
   1 дозволу	редакції
   1 джерело	проблеми
   1 ворожим	Недовіра
   1 власних	помилках
   1 виникає	проблема
   1 вивчили	популізм
   1 вибирає	сміятися
   1 вибирає	боротися
   1 верстви	Популізм
   1 вдалося	зберегти
   1 анексії	Західної
   1 активна	меншість
   1 України	Інститут
   1 Снайдер	українці
   1 Леніним	Гітлером
   1 КОЛОНКИ	ДАЙДЖЕСТ
   1 історії	людства
   1 історик	Віталій
   1 частіше	звучало
   1 упізати	Михайлв
   1 скільки	мітинги
   1 порядку	денного
   1 повинен	терпіти
   1 плакати	Частина
   1 народну	міліцію
   1 латишів	України
   1 кричати	пошепки
   1 збирали	стільки
   1 замість	плакати
   1 головах	Частина
   1 генетик	Можливо
   1 арсенал	методів
   1 активну	частину
   1 України	Простий
   1 України	Можливо
   1 Сухових	задавав
   1 Протест	латишів
   1 Простий	селянин
   1 Прийшов	Петлюра
   1 КОРОТКО	КОЛОНКИ
   1 Державі	Кривава
   1 Гетьман	воєнний
   1 існують	творчі
   1 імперія	Австро
   1 четверо	солдат
   1 систему	власну
   1 півтори	тисячі
   1 питання	вибору
   1 лідерам	нагорі
   1 крупним	планом
   1 головах	значно
   1 вдалося	Країна
   1 банками	центри
   1 Складно	знайти
   1 Можливо	травми
   1 Мартіна	Лютера
   1 КОРОТКО	ТЕКСТИ
   1 ГОЛОВНА	ТЕКСТИ
   1 стільки	людей
   1 перебіг	подій
   1 місяців	Потім
   1 муралом	Крути
   1 малюють	мурал
   1 конкурс	есеїв
   1 здатний	взяти
   1 звернув	увагу
   1 жахіття	війни
   1 досягли	своєї
   1 далеких	ночей
   1 гетьман	Павло
   1 вимагає	вищої
   1 анексії	Криму
   1 агресії	після
   1 Читайте	також
   1 України	Після
   1 Соляний	похід
   1 Петлюра	Потім
   1 Небесна	сотня
   1 Кривава	бійня
   1 Думська	площа
   1 Гетьман	Павло
   1 ІСТОРІЯ	БЛОГИ
   1 причина	чому
   1 порядок	своя
   1 питання	Мало
   1 міліцію	Ідея
   1 замість	того
   1 залишив	його
   1 доброго	розв
   1 втілити	його
   1 агресії	Ясна
   1 Україна	може
   1 Титанік	ляже
   1 Суличич	Київ
   1 Петлюра	Київ
   1 Воєнний	стан
   1 історії	Але
   1 столиці	Так
   1 ресурси	щоб
   1 питанні	все
   1 питання	Але
   1 негарне	про
   1 майдани	але
   1 держави	має
   1 держави	бич
   1 голодом	уже
   1 вимагає	від
   1 виклики	які
   1 Україні	але
   1 Можливо	він
   1 Майдані	був
   1 Майдану	Нам
   1 трамваї	не
   1 тиснути	на
   1 терпіти	ні
   1 селянин	зі
   1 режимів	що
   1 прожила	ще
   1 програв	цю
   1 програв	Як
   1 прийшов	до
   1 пошепки	на
   1 питання	Це
   1 папірці	що
   1 означає	що
   1 обіцяло	те
   1 настали	по
   1 мітинги	за
   1 мільйон	на
   1 лідерів	не
   1 лідерів	до
   1 ковадло	на
   1 зробити	те
   1 заходів	до
   1 денного	що
   1 графіку	це
   1 галузях	де
   1 встигли	до
   1 високою	Не
   1 виборах	до
   1 вважали	за
   1 України	та
   1 України	не
   1 Україна	не
   1 Путіним	та
   1 Перейти	до
   1 Бересті	на
   1 хлопців	з
   1 сумніви	у
   1 стільки	у
   1 столиці	У
   1 скільки	в
   1 порядок	і
   1 поразки	З
   1 питання	І
   1 перемир	я
   1 лідерах	у
   1 зростає	і
   1 встояла	у
   1 виборах	є
   1 агресії	у
   1 агресія	у
   1 Шаповал	М
   1 Чичерін	у
   1 України	і
   1 України	У
   1 Майдані	У
   1 народів	e5c754f
   1 Петлюри	872dae6
   1 мітинги	8
   1 Колонки	7e176a8
   1 Коротко	28
   1 похибки	2
   1 початку	1990
   1 початку	1918
   1 навесні	1917
   1 березні	1917
   1 Навесні	1917
   1 Коцький	1917
   1 швидше	відбуватиметься
   1 Цунамі	громадянськості
   1 частка	відповідальних
   1 здатні	відтворюватися
   1 Ганьба	Скоропадському
   1 умовах	тоталітарного
   1 умовах	деморалізації
   1 список	позапартійних
   1 методи	інформаційної
   1 доволі	популістським
   1 вперше	опублікований
   1 Кирило	Мефодіївської
   1 тільки	українському
   1 царині	економічній
   1 самого	громадянина
   1 мусили	конкурувати
   1 лідери	української
   1 довіру	нетерплячої
   1 візьме	більшовиків
   1 ТЕКСТИ	ФОТОГАЛЕРЕЇ
   1 Справа	Української
   1 шукали	можливості
   1 умовах	російської
   1 солдат	Хрещатиком
   1 святах	демократії
   1 своїми	особистими
   1 робили	більшовики
   1 разюче	нагадувала
   1 пожежі	найбільшої
   1 обіцяв	розпустити
   1 носили	Хрещатиком
   1 кишені	Українська
   1 завжди	отримувала
   1 газета	Кієвлянінъ
   1 власну	банківську
   1 Справа	огіївських
   1 Майдан	радикально
   1 Латиші	большевики
   1 іншими	частинами
   1 умовах	російсько
   1 тільки	негативно
   1 старих	методичок
   1 самими	викликами
   1 правда	Історична
   1 масову	суспільну
   1 змінив	більшість
   1 змогли	відстояти
   1 дорого	коштувало
   1 голові	випустили
   1 велике	пророцтво
   1 більше	підривало
   1 ЄВРОПА	ЕКОНОМІКА
   1 язаний	активною
   1 шансів	втратити
   1 травми	минулого
   1 тисячі	місцевих
   1 тисячі	багнетів
   1 самими	травмами
   1 рівнем	середній
   1 реванш	минулого
   1 расову	рівність
   1 значно	зручніше
   1 змогли	вплинути
   1 загроз	сьогодні
   1 досвід	минулого
   1 грудня	Держкіно
   1 власну	платіжну
   1 більше	латишами
   1 борись	Українці
   1 Яценюк	Турчинов
   1 Тамара	Архипчук
   1 Першої	світової
   1 Лідери	зазвичай
   1 Австро	Угорщина
   1 язного	дозволу
   1 хотіла	швидких
   1 тільки	трамваї
   1 розпад	України
   1 разюче	нагадує
   1 прагне	простих
   1 правда	ГОЛОВНА
   1 океану	історії
   1 нагорі	скільки
   1 межами	України
   1 значно	більшої
   1 змогли	зробити
   1 згодом	програв
   1 зазнав	поразки
   1 досить	високою
   1 гинуть	першими
   1 відтак	прийшов
   1 всьому	порядок
   1 ведено	Леніним
   1 більше	активна
   1 борись	Питання
   1 бачило	крупним
   1 адресу	Петлюри
   1 Якість	лідерів
   1 Тімоті	Снайдер
   1 Тараса	Україна
   1 ТЕКСТИ	КОРОТКО
   1 ПРОЕКТ	КОРОТКО
   1 Микита	Шаповал
   1 ідеями	дорого
   1 творчу	роботу
   1 рівень	цілого
   1 румуни	поляки
   1 наведе	всьому
   1 лідери	навіть
   1 дідусі	кажуть
   1 ганьба	відтак
   1 більше	шансів
   1 батька	Тараса
   1 Петрів	прибув
   1 Майдан	збирав
   1 Дніпру	Цілком
   1 Більша	частка
   1 фільму	Крути
   1 умовах	війни
   1 розпад	армії
   1 почали	діяти
   1 мирних	років
   1 масові	акції
   1 людини	проти
   1 людини	майже
   1 кінець	війні
   1 значно	ліпше
   1 знайти	точну
   1 знайти	працю
   1 згодом	війну
   1 збирав	сотні
   1 війною	тепер
   1 встали	щитом
   1 ведуть	війну
   1 болючі	кризи
   1 Тільки	тепер
   1 Лютера	Кінга
   1 Заходу	Тобто
   1 Дмитра	Коржа
   1 цікаво	коли
   1 центри	яких
   1 уявити	собі
   1 тільки	тоді
   1 творчі	сили
   1 робота	свої
   1 навіть	тоді
   1 навіть	дещо
   1 лічать	себе
   1 когось	було
   1 казати	щось
   1 других	було
   1 досвід	може
   1 гірший	шлях
   1 грудня	Село
   1 героях	цієї
   1 власні	руки
   1 Цілком	може
   1 Москви	Тоді
   1 Методи	були
   1 шматки	Про
   1 хотіли	йти
   1 хороша	Але
   1 роботу	над
   1 прийде	сам
   1 обіцяв	усе
   1 міщани	усе
   1 літніх	між
   1 кажуть	або
   1 досвід	пам
   1 виклик	для
   1 Правда	Усі
   1 Країна	без
   1 Версія	для
   1 ілюзія	що
   1 прийде	то
   1 прибув	до
   1 поляки	та
   1 планом	за
   1 нікуди	не
   1 ніколи	не
   1 меншос	ті
   1 масках	на
   1 літніх	та
   1 латиші	це
   1 книжок	де
   1 кишені	Як
   1 задача	не
   1 довіра	до
   1 грудня	На
   1 гаслах	до
   1 валюта	Чи
   1 бюджет	чи
   1 Довіра	до
   1 Ганьба	на
   1 язання	в
   1 ходили	У
   1 умовах	У
   1 тільки	і
   1 роботу	у
   1 примус	і
   1 партії	У
   1 одного	з
   1 нагорі	в
   1 зникло	з
   1 змогла	у
   1 зборів	у
   1 завжди	є
   1 життям	А
   1 деінде	у
   1 відбір	у
   1 верств	і
   1 бачили	в
   1 бабусі	і
   1 Леніна	А
   1 ІНТЕРВ	Ю
   1 ЗНАЙТИ	____________________
   1 роботи	447c3f7
   1 більше	3a0db24
   1 травня	2018
   1 новини	2018
   1 грудня	2013
   1 тільки	20
   1 вибору	20
   1 ВОЛИНЬ	1943
   1 травня	1918
   1 квітні	1918
   1 закони	16
   1 вперше	100
   1 ТАБЛОID	ЖИТТЯ
   1 взяти	відповідальність
   1 ліпше	відрефлексувало
   1 після	гетьманського
   1 новій	інформаційній
   1 добре	відпрацьовані
   1 влади	Скоропадський
   1 фугас	Соціалізація
   1 тепер	добровольців
   1 тепер	Незалежності
   1 межах	статистичної
   1 землі	підтверджена
   1 Треба	досліджувати
   1 стиля	прокламації
   1 проти	української
   1 права	застережені
   1 менше	конформісти
   1 війни	наближалась
   1 вибір	американців
   1 якого	присвячене
   1 явище	аморальної
   1 часів	Негативний
   1 часів	Голодомору
   1 часто	опиняємося
   1 тепер	напоролася
   1 стали	чемпіонами
   1 серце	зупинилося
   1 разом	повторював
   1 могло	встановити
   1 кінця	усвідомити
   1 кінця	усвідомили
   1 вищої	ініціативи
   1 вищої	активності
   1 чином	розганяла
   1 честь	стрільців
   1 фейки	Рашатудей
   1 точну	відповідь
   1 тепер	виявилося
   1 самих	Приблизно
   1 самих	Конформна
   1 ручне	керування
   1 решті	українців
   1 проти	диктатури
   1 подій	Полковник
   1 людей	одночасно
   1 землю	касується
   1 життя	збудилася
   1 груди	комуніста
   1 війну	Неможливо
   1 влади	коштувала
   1 Перед	порожньою
   1 Києві	пролунали
   1 Києві	завершили
   1 Києві	більшість
   1 імені	Шевченка
   1 тепер	диктують
   1 перед	загрозою
   1 латиш	синоніми
   1 крицю	виходить
   1 зараз	друкують
   1 більш	сильними
   1 бійня	світової
   1 армію	простіше
   1 Кінга	польська
   1 Києві	захищало
   1 Євген	Головаха
   1 Ґанді	мітинги
   1 чимсь	ворожим
   1 цьому	питанні
   1 уряду	ресурси
   1 тепер	вдалося
   1 також	означає
   1 також	Останнє
   1 серед	найменш
   1 своїх	народів
   1 років	Україна
   1 після	початку
   1 проти	України
   1 потім	прийшли
   1 нього	прожила
   1 місто	байдуже
   1 мають	досвіду
   1 легко	упізати
   1 кінця	вивчили
   1 землю	селянам
   1 війни	красиві
   1 відео	Коротко
   1 Тепер	десятки
   1 Путін	програв
   1 ЖИТТЯ	ІСТОРІЯ
   1 щораз	більше
   1 через	болючі
   1 увагу	Тімоті
   1 тисяч	встали
   1 тисяч	Цунамі
   1 тепер	змогли
   1 тепер	змогла
   1 тепер	Тільки
   1 серби	шукали
   1 рівня	цілого
   1 руках	самого
   1 руках	носили
   1 права	людини
   1 падає	довіра
   1 майже	завжди
   1 легко	уявити
   1 кухні	казати
   1 крики	Ганьба
   1 знову	досить
   1 діяти	Методи
   1 герої	гинуть
   1 війни	тільки
   1 внизу	Якість
   1 бодай	когось
   1 ФОРУМ	ЄВРОПА
   1 язала	Росія
   1 щитом	перед
   1 чужої	опіки
   1 число	якого
   1 також	варто
   1 таким	чином
   1 років	Путін
   1 похід	Ґанді
   1 полки	імені
   1 площа	тепер
   1 надто	довго
   1 менше	вісім
   1 війні	проти
   1 варта	таким
   1 армію	Відео
   1 Тепер	Путін
   1 Києві	проти
   1 Влада	надто
   1 БЛОГИ	ФОРУМ
   1 своєї	мети
   1 років	тому
   1 рацію	Київ
   1 після	того
   1 проти	тебе
   1 перед	тими
   1 перед	нами
   1 опіки	Чужа
   1 месію	який
   1 маємо	бути
   1 запам	ятав
   1 життя	Ідея
   1 довго	була
   1 гроші	Адже
   1 війни	було
   1 вжити	всіх
   1 вбито	усіх
   1 армії	дуже
   1 Треба	мати
   1 Празі	нове
   1 Потім	було
   1 Потім	були
   1 Крути	тоді
   1 Крути	ФОТО
   1 Коржа	Тоді
   1 Києві	одні
   1 Гумор	стає
   1 інших	але
   1 текст	був
   1 життя	від
   1 есеїв	Сто
   1 війні	мир
   1 війни	які
   1 війни	яку
   1 війни	або
   1 війни	Всі
   1 Через	рік
   1 Росія	ніж
   1 Путін	раз
   1 Києві	рід
   1 ВІДЕО	УСІ
   1 часто	не
   1 часах	що
   1 тролі	не
   1 самих	На
   1 ринку	не
   1 прямі	як
   1 опіка	не
   1 мурал	із
   1 кризи	це
   1 дошки	на
   1 гроші	Що
   1 грала	за
   1 війну	Це
   1 влади	на
   1 варто	не
   1 булат	Ця
   1 акції	за
   1 Тобто	ми
   1 Решта	не
   1 цього	в
   1 тисяч	у
   1 тисяч	а
   1 тепер	є
   1 сотня	і
   1 років	у
   1 працю	і
   1 права	і
   1 подій	у
   1 молот	і
   1 могли	б
   1 майже	в
   1 життя	у
   1 життя	А
   1 вісім	з
   1 війни	і
   1 війни	І
   1 владі	у
   1 владу	є
   1 влада	є
   1 армію	і
   1 Путін	у
   1 Литви	у
   1 Криму	у
   1 Києва	і
   1 ШАЛОМ	INT
   1 Відео	8dd5a82
   1 друку	835a101
   1 майна	40cdd5c
   1 січні	2014
   1 після	2014
   1 майже	20
   1 Після	1991
   1 ночей	1921
   1 січня	1918
   1 Крути	1918
   1 Києві	1918
   1 після	1917
   1 інших	10
   1 майже	10
   1 вони	інтернаціоналісти
   1 себе	відповідальність
   1 тоді	Посттоталітарні
   1 Ідея	демілітарізації
   1 який	мобілізовувала
   1 свою	неспроможність
   1 такі	вільноринкові
   1 стан	запроваджував
   1 одні	маніфестувати
   1 Тоді	українізовані
   1 свою	Незалежність
   1 році	розраховував
   1 року	Грушевського
   1 люди	народжуються
   1 часи	випробувань
   1 ціле	суспільство
   1 усій	Українській
   1 тому	залишаються
   1 року	представник
   1 року	знадобилося
   1 менш	привабливим
   1 мати	впевненість
   1 жила	самостійним
   1 дещо	перевищують
   1 були	застосовані
   1 Теми	Грушевський
   1 чому	українська
   1 цієї	реальності
   1 цієї	карикатури
   1 умов	позитивних
   1 тоді	українська
   1 році	республіку
   1 році	Українська
   1 року	сповнилося
   1 огні	пробуджена
   1 наша	республіка
   1 може	розпастися
   1 може	радикально
   1 коли	пересічний
   1 змін	Захоплення
   1 дуже	спрощувала
   1 всіх	публікацій
   1 бути	позитивним
   1 бути	ефективним
   1 Рада	Українська
   1 ятих	хлопчиків
   1 юрма	відповіла
   1 чуло	Більшість
   1 усіх	сільських
   1 тоді	українцям
   1 свої	прагнення
   1 році	київський
   1 році	глузували
   1 році	більшість
   1 року	Водохреща
   1 одна	відповідь
   1 каже	київський
   1 день	очікували
   1 бути	свідомими
   1 були	найбільші
   1 Тоді	українцям
   1 Тоді	російська
   1 Рада	втрачаючи
   1 Мало	оголосити
   1 Київ	залишався
   1 Київ	Хронікери
   1 інші	дивитися
   1 який	українці
   1 який	відсоток
   1 чого	залежить
   1 чехи	Українці
   1 ціну	недовіри
   1 хати	завітали
   1 усім	Проблема
   1 тому	популізм
   1 тому	Недовіра
   1 тоді	українці
   1 стає	помітною
   1 року	виходили
   1 одна	перевага
   1 один	трудящий
   1 один	спільний
   1 один	потужний
   1 один	знайомий
   1 обов	язковими
   1 кому	захищати
   1 коли	державні
   1 кого	опертися
   1 возз	єднатися
   1 було	потрібно
   1 було	написано
   1 було	знайдено
   1 була	загрозою
   1 була	вихована
   1 Тоді	століття
   1 Раду	захищало
   1 Комп	єнського
   1 Ідея	вільного
   1 щось	негарне
   1 тому	Навесні
   1 того	порядку
   1 сили	втілити
   1 свій	порядок
   1 самі	виклики
   1 року	гетьман
   1 одна	причина
   1 мала	доброго
   1 крик	дружини
   1 дуже	складно
   1 десь	півтори
   1 всіх	заходів
   1 всіх	галузях
   1 вона	вимагає
   1 було	десятки
   1 була	справою
   1 буде	тиснути
   1 Раді	війська
   1 Ради	Гетьман
   1 Весь	арсенал
   1 усім	цікаво
   1 таке	бюджет
   1 союз	зазнав
   1 собі	хороша
   1 себе	більше
   1 своя	робота
   1 саме	Латиші
   1 руки	Більша
   1 році	разюче
   1 році	лідери
   1 році	змогли
   1 розв	язання
   1 прав	людини
   1 вони	ніколи
   1 було	більше
   1 було	Ганьба
   1 НАНУ	нікуди
   1 стан	майже
   1 свої	права
   1 року	Через
   1 розв	язала
   1 нове	число
   1 може	легко
   1 мала	рацію
   1 коли	проти
   1 дуже	часто
   1 долю	інших
   1 всім	землю
   1 ваше	життя
   1 було	вбито
   1 були	крики
   1 були	добре
   1 Чужа	опіка
   1 Ради	Тепер
   1 Київ	Путін
   1 Ґедз	Київ
   1 урок	який
   1 сякі	такі
   1 свої	сили
   1 свою	силу
   1 року	юрма
   1 року	Тому
   1 розп	ятих
   1 один	урок
   1 обов	язки
   1 нами	Тоді
   1 каже	один
   1 було	дуже
   1 Того	року
   1 шлях	ніж
   1 того	щоб
   1 слів	про
   1 силу	Але
   1 сила	діє
   1 році	Але
   1 одну	ніч
   1 кому	Під
   1 коли	цей
   1 його	без
   1 всіх	хто
   1 Ясна	річ
   1 НАНУ	від
   1 Київ	від
   1 ідею	до
   1 ятав	цю
   1 який	як
   1 чого	не
   1 хіба	це
   1 факт	що
   1 тому	не
   1 тоді	це
   1 того	як
   1 того	що
   1 тебе	не
   1 собі	що
   1 сили	та
   1 самі	не
   1 сама	по
   1 року	це
   1 року	до
   1 року	Бо
   1 ляже	на
   1 коли	ми
   1 знає	це
   1 жаль	ми
   1 даті	Не
   1 вона	не
   1 взяв	на
   1 бути	що
   1 було	як
   1 було	на
   1 Факт	що
   1 Тому	що
   1 Село	на
   1 Вона	не
   1 Адже	ті
   1 ідей	з
   1 яких	є
   1 язки	І
   1 тому	у
   1 стан	в
   1 собі	в
   1 року	у
   1 року	в
   1 року	І
   1 одні	і
   1 одну	з
   1 одне	й
   1 огні	в
   1 мети	в
   1 кулю	в
   1 його	в
   1 змін	у
   1 було	і
   1 було	У
   1 були	у
   1 Тоді	в
   1 Одне	з
   1 межі	1917
   1 Київ	1917
   1 року	15
   1 ФОТО	14
   1 ФОТО	12
   1 тоді	116
   1 Київ	1
   1 ПРО	ПРОЕКТЗВОРОТНІЙ
   1 час	більшовицького
   1 був	поміркованіший
   1 від	самостійності
   1 щоб	компенсувати
   1 час	революційних
   1 ніч	проголошення
   1 лад	Грушевського
   1 від	меморіальної
   1 яка	регулюється
   1 щоб	перекладати
   1 хто	протистоїть
   1 тим	Універсалом
   1 під	переляканий
   1 про	більшовиків
   1 наш	неприродний
   1 від	більшовиків
   1 все	залишається
   1 щоб	українська
   1 так	Українську
   1 рік	зустрічали
   1 про	соборність
   1 про	готовність
   1 ніж	американці
   1 нас	напруженої
   1 дві	паралельні
   1 він	фінансував
   1 від	опитування
   1 від	загального
   1 всі	безробітні
   1 був	свідченням
   1 був	негативний
   1 Час	усвідомити
   1 УНР	Центральна
   1 Але	насамперед
   1 щоб	наповнити
   1 щоб	зрозуміти
   1 щоб	відновити
   1 хто	намагався
   1 має	розпочати
   1 для	особистої
   1 він	начитався
   1 був	вихований
   1 бич	українців
   1 ФСБ	поздували
   1 Усі	втомилися
   1 УСІ	МАТЕРІАЛИ
   1 Так	жартувала
   1 які	вважають
   1 щоб	провести
   1 тих	запитань
   1 суб	єктність
   1 ніж	століття
   1 нас	сьогодні
   1 дій	Холодної
   1 для	минулого
   1 Але	сьогодні
   1 які	знищили
   1 яку	звернув
   1 цей	Титанік
   1 хто	залишив
   1 хто	закидав
   1 тих	далеких
   1 над	муралом
   1 над	банками
   1 має	підняти
   1 від	початку
   1 все	частіше
   1 був	здатний
   1 але	джерело
   1 УНР	обіцяло
   1 Але	загроза
   1 Але	виникає
   1 які	готові
   1 які	бачило
   1 чия	візьме
   1 чим	більше
   1 хто	нагорі
   1 тих	умовах
   1 тим	швидше
   1 тим	більше
   1 нав	язаний
   1 мир	прийде
   1 люб	язного
   1 діє	навіть
   1 дно	океану
   1 дві	тисячі
   1 вже	бачили
   1 був	вперше
   1 але	змогли
   1 Усі	новини
   1 ПРО	ПРОЕКТ
   1 Він	обіцяв
   1 Але	тільки
   1 Але	бабусі
   1 іще	більш
   1 ніж	ручне
   1 для	цього
   1 для	друку
   1 від	війни
   1 вас	самих
   1 без	майна
   1 або	часів
   1 або	Литви
   1 Чим	менше
   1 Цей	текст
   1 Усі	права
   1 Усі	відео
   1 Але	також
   1 Але	майже
   1 іще	одна
   1 які	самі
   1 яку	розв
   1 хто	взяв
   1 усі	вони
   1 усе	всім
   1 усе	було
   1 про	який
   1 про	ціну
   1 ніч	було
   1 мир	усім
   1 від	чого
   1 був	менш
   1 Сто	слів
   1 Про	свої
   1 Нам	усім
   1 Іще	одна
   1 хто	був
   1 тих	які
   1 там	нєт
   1 рік	від
   1 рід	час
   1 під	неї
   1 для	нас
   1 від	нас
   1 від	вас
   1 був	нав
   1 УНР	був
   1 Під	час
   1 Але	іще
   1 Але	чим
   1 Але	цих
   1 Але	тих
   1 так	як
   1 так	Чи
   1 сам	по
   1 річ	що
   1 рух	до
   1 раз	за
   1 пил	зі
   1 нєт	як
   1 неї	не
   1 між	не
   1 дня	на
   1 все	це
   1 але	ці
   1 УНР	це
   1 УНР	не
   1 Але	це
   1 Але	ми
   1 уже	в
   1 рік	у
   1 мир	і
   1 йти	в
   1 Всі	в
   1 так	19
   1 УГА	17
   1 із	ультрапопулізмом
   1 із	нонконформістами
   1 цю	відповідальність
   1 що	деморалізовану
   1 не	пересмикування
   1 що	саморегуляція
   1 на	популістських
   1 за	Всеросійський
   1 до	інформаційної
   1 чи	незалежність
   1 це	соціологічна
   1 та	Університету
   1 та	Сагайдачного
   1 не	сприймаються
   1 на	диктаторські
   1 на	випробування
   1 до	самостійного
   1 до	незалежності
   1 до	забезпечення
   1 із	полковником
   1 що	керівництво
   1 що	забезпечили
   1 чи	гавелівська
   1 чи	Центральної
   1 цю	конкуренцію
   1 та	потерпівших
   1 не	висовувайся
   1 не	визначилися
   1 на	осцилографі
   1 до	фотогалереї
   1 На	Прикарпатті
   1 ЗВ	ЯЗОКРЕКЛАМА
   1 її	Українська
   1 як	інструмент
   1 та	ольгінські
   1 та	Януковичем
   1 не	спекуляція
   1 не	втручалося
   1 на	цілковитий
   1 на	найближчих
   1 на	Вогнехреща
   1 за	радянських
   1 до	опитування
   1 до	завершення
   1 до	Установчих
   1 до	Вогнехреща
   1 Це	оголошення
   1 НА	САЙТІАРХІВ
   1 її	прикладом
   1 що	проминули
   1 що	приходять
   1 що	большевик
   1 що	Четвертий
   1 ці	показники
   1 ці	комплекси
   1 це	актуальна
   1 не	витримала
   1 не	висовуйся
   1 на	диктатуру
   1 на	більшість
   1 на	Львівщині
   1 му	Олександр
   1 ми	заявляємо
   1 за	правилами
   1 до	федерації
   1 На	велелюдні
   1 із	верствою
   1 як	зазвичай
   1 як	Троцький
   1 що	українці
   1 цю	ситуацію
   1 це	розуміли
   1 це	виглядає
   1 та	освітнім
   1 та	Білорусі
   1 не	забувати
   1 на	цвинтарі
   1 на	обіцянки
   1 на	Арсеналі
   1 до	вбивства
   1 го	Сценарій
   1 ви	вважаєте
   1 Ця	недовіра
   1 ХХ	столітті
   1 На	майданах
   1 За	виданням
   1 що	існують
   1 що	настали
   1 що	лідерам
   1 що	геноцид
   1 ті	папірці
   1 та	лідерів
   1 та	жахіття
   1 та	Чичерін
   1 не	стільки
   1 не	повинен
   1 не	кричати
   1 не	збирали
   1 не	досягли
   1 не	встигли
   1 не	володіє
   1 на	початку
   1 на	головах
   1 на	айсберг
   1 до	держави
   1 Як	Гетьман
   1 Чи	мислимо
   1 УЖ	Читайте
   1 На	графіку
   1 На	виборах
   1 із	Євгена
   1 як	прийде
   1 що	робили
   1 що	Майдан
   1 це	гірший
   1 то	наведе
   1 та	деінде
   1 та	Леніна
   1 та	Євгена
   1 по	святах
   1 по	голові
   1 по	Дніпру
   1 не	хотіли
   1 не	ходили
   1 не	лічать
   1 не	зникло
   1 не	завжди
   1 не	готові
   1 не	вперше
   1 не	ведуть
   1 на	шматки
   1 на	масову
   1 на	адресу
   1 му	разюче
   1 зі	старих
   1 за	своїми
   1 за	расову
   1 за	межами
   1 до	ведено
   1 де	тільки
   1 Ця	задача
   1 Це	ілюзія
   1 Де	валюта
   1 як	серце
   1 як	молот
   1 що	явище
   1 що	зараз
   1 що	герої
   1 ще	менше
   1 це	щораз
   1 це	також
   1 це	гроші
   1 та	серби
   1 та	решті
   1 та	вжити
   1 од	війни
   1 не	могло
   1 не	мають
   1 на	честь
   1 на	руках
   1 на	кухні
   1 на	крицю
   1 на	землю
   1 на	владу
   1 на	вибір
   1 ми	маємо
   1 зі	стиля
   1 за	інших
   1 за	разом
   1 за	права
   1 за	месію
   1 до	нього
   1 до	Києва
   1 го	років
   1 Де	гроші
   1 як	каже
   1 що	вона
   1 що	Київ
   1 ще	одна
   1 чи	знає
   1 це	свій
   1 це	наша
   1 це	були
   1 ті	самі
   1 те	чого
   1 те	саме
   1 по	даті
   1 ні	один
   1 не	чуло
   1 не	одне
   1 не	один
   1 не	може
   1 не	мала
   1 не	жила
   1 на	себе
   1 на	межі
   1 на	кого
   1 на	день
   1 му	Весь
   1 ми	дуже
   1 за	свої
   1 за	долю
   1 до	хати
   1 до	всіх
   1 де	було
   1 Як	каже
   1 Що	таке
   1 Чи	були
   1 Ця	сила
   1 Не	факт
   1 Не	може
   1 На	жаль
   1 іх	там
   1 як	дві
   1 що	мир
   1 що	був
   1 чи	від
   1 це	вже
   1 ті	Чим
   1 не	так
   1 на	яку
   1 на	дно
   1 му	або
   1 ми	все
   1 де	всі
   1 го	все
   1 го	Але
   1 Це	був
   1 її	не
   1 як	ви
   1 що	ті
   1 чи	не
   1 це	не
   1 та	не
   1 ні	не
   1 на	це
   1 ми	її
   1 го	та
   1 Це	не
   1 як	і
   1 що	і
   1 що	у
   1 це	і
   1 ті	ж
   1 му	і
   1 Як	у
   1 Як	з
   1 Бо	в
   1 му	da0f29e
   1 чи	8
   1 та	30
   1 ті	20
   1 та	1918
   1 та	15
   1 з	ультрапопулістськими
   1 в	середньотерміновій
   1 і	посттоталітарні
   1 і	постколоніальні
   1 і	землевласників
   1 у	півмільйонному
   1 і	землевоасника
   1 в	українського
   1 М	Сріблянський
   1 і	сподіватися
   1 у	майбутньому
   1 й	пограбована
   1 в	майбутньому
   1 в	керівництві
   1 У	самостійній
   1 і	сьогодення
   1 я	Клаптикова
   1 у	протиріччя
   1 в	помешканні
   1 в	поколіннях
   1 в	автомобілі
   1 У	свідомості
   1 В	абсолютній
   1 і	прикласти
   1 і	обмеження
   1 і	добробати
   1 і	внаслідок
   1 у	фельєтоні
   1 у	листопаді
   1 у	каструлях
   1 у	Київській
   1 й	культурно
   1 з	половиною
   1 з	київської
   1 з	виживання
   1 ж	запитання
   1 У	Запоріжжі
   1 А	фінансова
   1 І	збудилася
   1 і	століття
   1 і	створити
   1 і	вмирають
   1 і	виконати
   1 є	загрозою
   1 у	черкесці
   1 у	синергію
   1 з	кинжалом
   1 в	казармах
   1 в	багатьох
   1 а	отримала
   1 Ю	ГОЛОКОСТ
   1 А	покарати
   1 і	майдани
   1 і	ковадло
   1 і	досягти
   1 і	активна
   1 і	Небесна
   1 є	сумніви
   1 х	ставить
   1 у	лідерах
   1 у	березні
   1 у	Бересті
   1 в	історії
   1 в	перебіг
   1 в	головах
   1 У	власних
   1 П	Коцький
   1 і	розпад
   1 і	почали
   1 і	масках
   1 і	латиші
   1 і	згодом
   1 і	дідусі
   1 і	Заходу
   1 у	царині
   1 у	квітні
   1 у	власні
   1 з	іншими
   1 з	Москви
   1 в	пожежі
   1 б	знайти
   1 а	згодом
   1 У	героях
   1 І	прагне
   1 і	падає
   1 і	латиш
   1 і	запам
   1 і	грала
   1 є	знову
   1 у	цьому
   1 у	руках
   1 у	новій
   1 у	владі
   1 у	Празі
   1 в	часах
   1 в	січні
   1 в	межах
   1 в	життя
   1 в	груди
   1 в	армію
   1 а	тепер
   1 А	потім
   1 і	ціле
   1 і	обов
   1 є	обов
   1 у	всіх
   1 з	цієї
   1 з	умов
   1 з	того
   1 в	часи
   1 в	усій
   1 в	одну
   1 в	огні
   1 а	тоді
   1 З	року
   1 В	одну
   1 В	огні
   1 А	який
   1 А	тому
   1 І	мала
   1 І	вона
   1 і	цих
   1 і	під
   1 і	лад
   1 є	пам
   1 у	тих
   1 у	ФСБ
   1 й	рік
   1 з	люб
   1 в	тих
   1 в	рік
   1 в	УНР
   1 У	ніч
   1 З	дня
   1 і	ті
   1 є	за
   1 у	ХХ
   1 й	те
   1 І	це
   1 р	А
   1 У	2013
   1 У	2010
   1 С	2
   1 у	1940
   1 у	1939
   1 в	1921
   1 zinchenko	jpg
   1 ukrainian	bluecoats
   1 sk300	jpg
   1 k	bahmanis
   1 jpg	Олександр
   1 jpg	Володимир
   1 jpg	Приватна
   1 jpg	Крістапс
   1 jpg	Думська
   1 jpg	Микита
   1 jpg	Перед
   1 jpg	Play
   1 jpg	60
   1 gif	Це
   1 da0f29e	ukrainian
   1 cr	jpg
   1 bluecoats	1918
   1 bahmanis	jpg
   1 af527f4	jpg
   1 ____________________	Українська
   1 _	Вівторок
   1 VS	ультрапопулізм
   1 RSS	ЗНАЙТИ
   1 Play	1918
   1 L	ПРО
   1 IV	Універсал
   1 INT	L
   1 INS	Теми
   1 INS	INS
   1 8eae18a	10
   1 8dd5a82	sk300
   1 872dae6	8eae18a
   1 835a101	zinchenko
   1 8	Складно
   1 8	та
   1 7e176a8	123
   1 6b3b20df2a	jpg
   1 60	Тамара
   1 60	215
   1 5bb1c23	3
   1 53	19
   1 5161a26	k
   1 50	українців
   1 5	На
   1 5	С
   1 47	20
   1 447c3f7	cr
   1 40cdd5c	5bb1c23
   1 3a0db24	6b3b20df2a
   1 300	років
   1 30	літніх
   1 3	jpg
   1 28	грудня
   1 27	листопада
   1 25	січня
   1 22	травня
   1 22	грудня
   1 215	60
   1 21	грудня
   1 2018	Історична
   1 2018	09
   1 2013	році
   1 2013	року
   1 2010	році
   1 20	українців
   1 20	літніх
   1 20	грудня
   1 20	готові
   1 20	років
   1 20	які
   1 2	У
   1 2	5
   1 2	2
   1 1991	року
   1 1990	х
   1 1943	КАНАДІАНА
   1 1940	му
   1 1939	му
   1 1921	році
   1 1921	року
   1 1918	гетьман
   1 1918	Протест
   1 1918	р
   1 1918	й
   1 1918	gif
   1 1918	17
   1 1917	Українська
   1 1917	За
   1 1917	В
   1 1917	5
   1 19	грудня
   1 19	січня
   1 17	53
   1 17	00
   1 16	січня
   1 15	грудня
   1 15	Усі
   1 123	jpg
   1 12	47
   1 116	хлопців
   1 100	РЕФОРМАЦІЯ
   1 100	років
   1 10	мирних
   1 10	років
   1 10	чи
   1 10	jpg
   1 1	травня
   1 09	01
   1 07	22
   1 05	07
   1 01	Версія
   1 0000	Повернутися
   1 00	21
   1 0	0000
