  19 Вацлав	Гавел
   8 тому	що
   8 в	правді
   6 Вацлава	Гавела
   6 життя	в
   5 що	все
   5 те	що
   5 що	в
   5 jpg	Вацлав
   5 2018	_
   4 для	Гавела
   4 Міф	про
   4 об	єднує
   4 чи	не
   4 це	не
   4 в	Чехословаччині
   4 в	системі
   4 В	Гавела
   4 в	цьому
   4 і	в
   4 INS	INS
   4 2	jpg
   4 1968	року
   4 12	2018
   3 Сила	безсилих
   3 всіх	країн
   3 лише	за
   3 ледь	не
   3 під	час
   3 все	є
   3 що	Гавел
   3 ті	роки
   3 в	тому
   3 В	цей
   3 і	не
   3 і	є
   3 Т	Г
   3 Р	М
   3 1	jpg
   2 відповідальність	перед
   2 громадянського	суспільства
   2 президентом	Чехословаччини
   2 суспільства	та
   2 аполітичну	політику
   2 Українська	правда
   2 Характерно	що
   2 розумінні	Гавела
   2 Історична	правда
   2 пролетарі	всіх
   2 незалежно	від
   2 проводить	в
   2 народився	в
   2 здавалося	б
   2 останнім	президентом
   2 власного	сумління
   2 молодого	Гавела
   2 чоловіка	який
   2 враження	на
   2 міської	буржуазії
   2 система	змінює
   2 Роллінг	Стоунз
   2 Радомир	Мокрик
   2 правила	гри
   2 звідси	починається
   2 правда	Історична
   2 згідно	власного
   2 значну	частину
   2 Гавела	він
   2 Гавела	як
   2 одного	й
   2 Хартію	77
   2 Мілош	Гавел
   2 існує	щось
   2 Гавел	який
   2 Гавел	веде
   2 Гавел	з
   2 його	власним
   2 своє	життя
   2 слів	про
   2 щось	що
   2 того	ж
   2 Жити	в
   2 про	чоловіка
   2 між	різними
   2 він	починає
   2 він	займає
   2 цей	комин
   2 цей	світ
   2 він	пише
   2 від	того
   2 сім	ї
   2 сім	я
   2 все	ж
   2 вже	в
   2 був	в
   2 не	система
   2 що	людина
   2 на	Гавела
   2 на	цьому
   2 не	тому
   2 не	лише
   2 за	себе
   2 за	його
   2 що	цей
   2 що	нас
   2 що	не
   2 що	ми
   2 що	і
   2 з	президентом
   2 з	покоління
   2 в	розумінні
   2 з	ключових
   2 Г	Масарика
   2 ї	міської
   2 в	язниці
   2 в	театрі
   2 Е	Бенеша
   2 в	армії
   2 й	того
   2 в	сім
   2 І	все
   2 jpg	Обкладинка
   2 idnes	cz
   2 60	х
   2 1989	року
   2 1978	році
   1 ТЕКСТИКОРОТКОКНИЖКИАРТЕФАКТИКОЛОНКИВІДЕОДАЙДЖЕСТІНТЕРВ	ЮСТУДІЇКАЛЕНДАРЕ
   1 КСКУРСІЇБЛОГОСФЕРА	АВТОРИЗАЦІЯ
   1 ЮСТУДІЇКАЛЕНДАРЕ	КСКУРСІЇБЛОГОСФЕРА
   1 відповідальності	Відповідальності
   1 Відповідальність	усвідомлення
   1 відповідальність	ґрунтується
   1 індивідуальність	Мотивація
   1 закомпостованими	квитками
   1 відповідальності	ключове
   1 Відповідальність	Вацлава
   1 відповідальність	лише
   1 відповідальність	це
   1 безперспективною	чи
   1 Відповідальності	не
   1 відповідальність	в
   1 соціалістичного	тоталітаризму
   1 малодослідженим	залишається
   1 пострадянського	простору
   1 чехословацького	аналога
   1 державотворення	Поняття
   1 соціалістичного	табору
   1 УВІЙТИВІДМІНИТИ	Якщо
   1 інтелектуалізму	та
   1 гіперпосиланням	на
   1 ПРОЕКТЗВОРОТНІЙ	ЗВ
   1 Чехословаччині	відбувається
   1 комуністичного	перевороту
   1 екзистенційної	значущості
   1 соціалістичної	диктатури
   1 Чехословаччини	країнами
   1 зареєструйтесь	Забули
   1 Чехословаччини	першої
   1 Чехословаччини	Європи
   1 інтегрованості	буття
   1 соціалістичний	режим
   1 геронтократією	Після
   1 Чехословаччині	Гавел
   1 Чехословаччині	ВІДЕО
   1 правозахисному	русі
   1 правозахисного	руху
   1 дисидентського	руху
   1 Чехословаччину	ФОТО
   1 Чехословаччини	Свій
   1 співрозмовнику	але
   1 Чехословаччині	був
   1 використовуйте	ті
   1 Загальновідомо	що
   1 Чехословаччини	а
   1 Чехословаччина	XX
   1 переслідуваних	VONS
   1 Чехословаччина	INS
   1 несправедливо	переслідуваних
   1 Гарвардського	університету
   1 екзистенційно	неправильна
   1 конструктивну	співпрацю
   1 встановленого	комунізму
   1 американською	культурою
   1 симптоматично	сьогодні
   1 інституційний	релігій
   1 філософського	діалогу
   1 розчаклування	природи
   1 приватизувати	природу
   1 екзистенційну	площину
   1 середньовічна	людина
   1 продовжується	правил
   1 парламентські	вибори
   1 масариківська	дрібна
   1 найголовнішій	своїй
   1 артикульоване	життя
   1 тоталітаризму	але
   1 президентства	Він
   1 дотримуватися	Він
   1 інтелектуалів	до
   1 тоталітарного	за
   1 пролетарської	це
   1 громадськості	та
   1 впорядкованим	що
   1 висловлювався	на
   1 Середньовіччя	Що
   1 президентства	Е
   1 найважливішою	є
   1 Альтернативою	є
   1 студентської	демонстрації
   1 підкоряється	встановленим
   1 встановленим	тоталітарним
   1 прихильників	аполітичної
   1 практиковану	моральність
   1 неправильним	Неправильно
   1 громадянське	суспільство
   1 коментування	публікацій
   1 Використання	матеріалів
   1 університету	всередині
   1 світоглядній	концепції
   1 найдрібніших	ситуаціях
   1 тоталітарним	правилам
   1 внутрішнього	відчуття
   1 Варшавського	договору
   1 керівництвом	Густава
   1 відбувається	судовий
   1 внутрішнього	вагання
   1 безбілетному	проїзді
   1 світобаченні	Гавела
   1 використовує	термін
   1 Компостувати	квиток
   1 усвідомлення	своєї
   1 усвідомлення	вищої
   1 католицького	крила
   1 арештовували	проте
   1 Варшавському	гетто
   1 усвідомлення	того
   1 проявляється	одна
   1 кантіанських	форм
   1 відбувається	прем
   1 університеті	Він
   1 демонстрації	від
   1 балансування	між
   1 розсиплеться	як
   1 продовженням	та
   1 повертається	до
   1 наслідування	як
   1 задумувалися	як
   1 відбувається	за
   1 письменником	і
   1 відчувається	і
   1 авторизації	використовуйте
   1 суспільство	симптоматично
   1 веберівське	розчаклування
   1 напередодні	Оксамитової
   1 намагається	переступити
   1 заручниками	суспільства
   1 залишається	драматургом
   1 визначенням	суспільства
   1 суспільства	тримається
   1 суспільства	споживання
   1 починається	захоплення
   1 перетворень	Пригадуємо
   1 майбутнього	президента
   1 забруднення	вторгнення
   1 єврейського	скаутингу
   1 український	скаутинги
   1 оксамитової	революції
   1 залишається	моральним
   1 абсолютному	горизонті
   1 Яворницький	Козацький
   1 Прикарпатті	оголосили
   1 Оксамитової	революції
   1 Оксамитової	Революції
   1 романтичних	лозунгах
   1 подорожував	Америкою
   1 католицьких	теологів
   1 закінчиться	Проблема
   1 включеності	громадян
   1 виставляння	табличок
   1 безнадійною	завідомо
   1 аполітичної	політики
   1 тоталітарну	систему
   1 суспільства	Головна
   1 піддавалася	утискам
   1 полемізуючи	пояснює
   1 особистості	Прогрес
   1 організацію	Комітет
   1 засновників	відомих
   1 цивілізації	Аккаду
   1 соратниками	прямує
   1 радянському	режиму
   1 католицизму	Цілком
   1 драматургом	навіть
   1 геніального	просто
   1 будівництва	дядько
   1 батьківщині	Гавела
   1 Українській	правді
   1 суспільства	Тобто
   1 суспільства	Гавел
   1 пролетарями	інших
   1 президентів	Гавел
   1 президентом	Чехії
   1 поширюються	чутки
   1 позитивному	сенсі
   1 організовує	першу
   1 намагається	вести
   1 літературну	групу
   1 заздалегідь	надає
   1 голодування	Гавел
   1 Радянського	Союзу
   1 Вацлавській	площі
   1 проступають	дуже
   1 починається	шлях
   1 позбавлення	волі
   1 переступити	межі
   1 обмежується	лише
   1 залишається	факт
   1 віднаходить	себе
   1 характерній	для
   1 угрупування	він
   1 суспільство	яке
   1 спостерігає	сам
   1 перебільшує	Він
   1 організації	яка
   1 неправильна	Про
   1 маніпуляції	від
   1 кориснішими	для
   1 знаходиться	під
   1 завершиться	але
   1 відмовилися	від
   1 впорядковує	цей
   1 авторитетом	але
   1 УгоВавречка	був
   1 Президентом	він
   1 АВТОРИЗАЦІЯ	Для
   1 ґрунтується	на
   1 суспільство	за
   1 результатів	чи
   1 провалилася	на
   1 президентом	та
   1 починається	те
   1 повторювати	що
   1 переконання	що
   1 моральність	за
   1 завершиться	Це
   1 журналістом	та
   1 жонглювання	бо
   1 відпускають	на
   1 впевненість	що
   1 вимагається	це
   1 арештованим	та
   1 ЯЗОКРЕКЛАМА	НА
   1 Повернімося	до
   1 Неправильно	що
   1 розходяться	з
   1 підприємцем	в
   1 президентом	в
   1 президентом	Т
   1 починається	з
   1 посилається	Р
   1 подобається	в
   1 переконання	у
   1 компромісів	з
   1 зустрічався	з
   1 здебільшого	у
   1 залишається	і
   1 залишається	в
   1 забарвлення	І
   1 голодування	в
   1 відповідати	В
   1 САЙТІАРХІВ	ТЕКСТИКОРОТКОКНИЖКИАРТЕФАКТИКОЛОНКИВІДЕОДАЙДЖЕСТІНТЕРВ
   1 називатиме	соціалістичний
   1 побудувати	конструктивну
   1 емігрувати	арештовували
   1 активістів	громадянське
   1 іронічного	забарвлення
   1 суспільних	перетворень
   1 закритістю	суспільства
   1 історичній	резиденції
   1 пропагував	аполітичну
   1 дефіцитами	закритістю
   1 буржуазної	республіки
   1 Вторгнення	радянських
   1 характерно	практично
   1 сексуальна	революція
   1 незнищенно	присутнім
   1 народилися	польський
   1 народження	учасників
   1 мисленнєва	рефлексія
   1 кіностудій	Баррандов
   1 вшанувавши	натомість
   1 Оксамитову	революцію
   1 технічного	прогресу
   1 підкорення	ритуалам
   1 найменшими	вчинками
   1 можливість	рухатися
   1 захоплення	молодого
   1 аналогічні	таблички
   1 абсолютний	горизонт
   1 історичним	містком
   1 центральну	позицію
   1 соціальних	мережах
   1 світогляду	Вацлава
   1 резиденції	королів
   1 радянським	колегам
   1 опозиційні	виступи
   1 нейтральну	позицію
   1 найбільших	успіхів
   1 заставлять	платити
   1 демократію	повинні
   1 відвертого	виступу
   1 встановлює	правила
   1 Посольство	Ізраїлю
   1 світогляду	Гавела
   1 свідомість	дитини
   1 радянських	військ
   1 підписанти	Хартії
   1 президента	Вацлав
   1 політичних	причин
   1 незалежним	життям
   1 невеличким	кроком
   1 впроваджує	одразу
   1 Обкладинка	книжки
   1 Григоренко	Таврія
   1 тримається	якраз
   1 споживання	Вирок
   1 російській	тюрмі
   1 президента	Гавел
   1 повернення	цього
   1 мистецьких	колах
   1 матеріалів	сайту
   1 масонських	ложах
   1 драматурга	часом
   1 драматичні	твори
   1 демократію	Гавел
   1 внутрішній	голос
   1 автентичне	життя
   1 РЕФОРМАЦІЯ	ШАЛОМ
   1 Обкладинка	книги
   1 Вінницький	архів
   1 Єврейський	Пласт
   1 усвідомити	щось
   1 становлять	ядро
   1 республіки	були
   1 поважаючий	себе
   1 драматурга	який
   1 робітників	від
   1 посиланням	для
   1 поводитися	так
   1 напрямками	він
   1 матеріалах	КГБ
   1 лояльніший	ніж
   1 залишиться	для
   1 закордоном	Міф
   1 драматурга	США
   1 публікацій	на
   1 продюсером	та
   1 природного	та
   1 припущення	чи
   1 комуністів	до
   1 значущості	це
   1 знаменника	На
   1 засуджують	до
   1 горизонтом	що
   1 відношення	до
   1 відношенню	до
   1 Пригадуємо	не
   1 Незважаючи	на
   1 харцерство	і
   1 республіки	Т
   1 письменник	і
   1 офіційному	з
   1 наскрізною	в
   1 народжений	в
   1 лояльність	І
   1 католицизм	і
   1 затримують	і
   1 дипломатом	а
   1 гвинтиками	в
   1 відповідно	в
   1 вторгнення	в
   1 вкоріненим	в
   1 важливості	І
   1 громадянин	1ee2c8d
   1 перевороту	1948
   1 соборність	05
   1 атмосфері	інтелектуалізму
   1 тотальної	інтегрованості
   1 створення	правозахисного
   1 ситуаціях	Компостувати
   1 залишився	письменником
   1 державним	керівництвом
   1 скаутингу	організації
   1 принаймні	намагається
   1 перемогла	тоталітарну
   1 моральним	авторитетом
   1 здорового	суспільства
   1 всередині	Радянського
   1 чуттєвого	припущення
   1 успішного	драматурга
   1 спільного	знаменника
   1 скаутинги	харцерство
   1 реформних	комуністів
   1 намагався	емігрувати
   1 висловлює	лояльність
   1 єднуються	пролетарі
   1 соціалізм	Артефакти
   1 принаймні	прикладом
   1 президент	проводить
   1 новорічне	звернення
   1 майбутній	президент
   1 Масариком	Майбутній
   1 Майбутній	драматург
   1 Литовські	партизани
   1 КАНАДІАНА	РЕВОЛЮЦІЯ
   1 справляло	неабияке
   1 працювати	техніком
   1 практичні	наслідки
   1 празькими	вулицями
   1 поступово	усувають
   1 передусім	цікавить
   1 очікувати	миттєвих
   1 офіційної	культури
   1 невловиме	апріорне
   1 концепції	Присутнє
   1 здавалася	сталевою
   1 виставить	табличку
   1 Протоколи	Вершиною
   1 ЕКОНОМІКА	ПОЛІТИКА
   1 єктивізує	природу
   1 цілковито	відомим
   1 технічний	прогрес
   1 суспільні	процеси
   1 статтіпро	свободу
   1 практична	сторона
   1 почесного	доктора
   1 пивзаводі	Трутнов
   1 оголосили	конкурс
   1 ненависть	Історія
   1 натомість	Рейгана
   1 насправді	ключове
   1 картковий	будинок
   1 драматург	зростав
   1 допомогою	Дрібної
   1 виступали	Роллінг
   1 богемного	способу
   1 атмосфера	значною
   1 Тимошенко	Генерал
   1 світогляд	Вацлав
   1 релігійні	мотиви
   1 режисером	навіть
   1 революції	Гавела
   1 пізнішому	тексті
   1 підтримує	ілюзію
   1 президент	країни
   1 правильно	чинити
   1 потрібний	ритуал
   1 політичну	партію
   1 поглядами	Гавела
   1 поведінка	завжди
   1 перемогти	брехню
   1 передусім	Вацлав
   1 оплачуємо	проїзд
   1 наслідком	будуть
   1 наприклад	підчас
   1 мотивація	цілком
   1 мислитель	Вацлав
   1 досягнути	успіху
   1 відібрано	значну
   1 всередині	Хартії
   1 вдячності	Людина
   1 Січеслава	Дніпра
   1 Козацький	Батько
   1 ГОЛОДОМОР	ВОЛИНЬ
   1 Історичну	правду
   1 фабричний	комин
   1 створюємо	якесь
   1 спільного	Якесь
   1 складають	вкрай
   1 рефлексія	Гавел
   1 революція	невід
   1 правлячий	режим
   1 покоління	Бітлз
   1 отримував	Проте
   1 особистий	вибір
   1 мільйонів	інших
   1 комунізму	Після
   1 допомагає	вести
   1 горизонті	буття
   1 Радянські	танки
   1 єднайтеся	Чому
   1 чоловіком	який
   1 створював	УРСС
   1 революцію	став
   1 продавець	стає
   1 пояснення	свої
   1 політичні	теми
   1 незначний	жест
   1 науковець	Теми
   1 місцевому	джаз
   1 забруднює	небо
   1 дозволено	лише
   1 відводить	роль
   1 абсолютно	самі
   1 Пролетарі	всіх
   1 Продавець	лише
   1 Мотивація	його
   1 Вавречкою	Фото
   1 складніша	Але
   1 розповідь	про
   1 революція	Сам
   1 підпадала	під
   1 продавців	які
   1 прикладом	для
   1 поставити	Ось
   1 навчилися	між
   1 набуваєте	суб
   1 міністром	без
   1 достатньо	щоб
   1 буржуазії	яка
   1 Баррандов	Дід
   1 сторонами	та
   1 створюють	ще
   1 стверджує	що
   1 співпрацю	це
   1 розуміння	що
   1 процвітає	На
   1 присутнім	на
   1 практично	не
   1 поставити	цю
   1 польський	та
   1 перебирає	на
   1 парламент	не
   1 очевидним	що
   1 найбільша	її
   1 матеріали	за
   1 культурою	Не
   1 зрозуміла	це
   1 здавалася	її
   1 гавлістів	по
   1 відчуттям	що
   1 відповіді	на
   1 відповідь	на
   1 впевнений	що
   1 випадково	за
   1 буржуазії	як
   1 спільного	з
   1 саксофоні	в
   1 революції	в
   1 працювати	в
   1 правильно	В
   1 поетичних	і
   1 повстання	у
   1 партизани	з
   1 обставини	і
   1 непростою	і
   1 консенсус	і
   1 драматург	В
   1 дитинстві	і
   1 диктатури	В
   1 гвинтиком	в
   1 відслужив	в
   1 виставляє	у
   1 виживання	І
   1 Революції	і
   1 Кустуріца	В
   1 Джексоном	а
   1 всередині	90
   1 покоління	60
   1 Артефакти	55a0ddd
   1 творчості	3fb1780
   1 учасників	36
   1 Сверстюка	25
   1 Паневежис	1945
   1 РЕВОЛЮЦІЯ	100
   1 звернення	1
   1 Окупація	Чехословаччини
   1 потрібно	дотримуватися
   1 сталевою	розсиплеться
   1 політику	практиковану
   1 країнами	Варшавського
   1 апріорне	усвідомлення
   1 сумління	віднаходить
   1 словесні	жонглювання
   1 серйозно	розходяться
   1 ритуалам	виставляння
   1 потрібне	відповідати
   1 осередок	єврейського
   1 миттєвих	результатів
   1 екології	залишається
   1 древньої	цивілізації
   1 висловом	Президентом
   1 тримають	аналогічні
   1 скаутинг	народжений
   1 порівнює	свідомість
   1 мстяться	радянським
   1 молодого	драматурга
   1 договору	Вторгнення
   1 безсилих	Незважаючи
   1 Проблема	відношення
   1 трамваєм	абсолютно
   1 табличку	наслідком
   1 побудови	здорового
   1 молодого	успішного
   1 відчуття	тотальної
   1 вчинками	створюємо
   1 Присутнє	розуміння
   1 ГОЛОКОСТ	ГОЛОДОМОР
   1 українці	виходили
   1 продавця	серйозно
   1 особисто	знайомий
   1 особиста	сутність
   1 неабияке	враження
   1 місцевої	академії
   1 місцевих	господах
   1 магазину	табличку
   1 кандидат	переможе
   1 загибелі	древньої
   1 головних	керівних
   1 відкрито	агітував
   1 власного	магазину
   1 безсилих	Дивіться
   1 академії	мистецтв
   1 хокеїсти	збірної
   1 суттєвим	впливом
   1 сторіччя	Холодна
   1 справляє	Америка
   1 празькою	богемою
   1 останній	відомий
   1 нездатні	охопити
   1 найменше	спільне
   1 життєвої	історії
   1 дисидент	політик
   1 горизонт	джерело
   1 водночас	висилає
   1 виходять	книжкою
   1 виборчій	комедії
   1 безсилих	Вацлава
   1 інтернет	видань
   1 теологів	Вацлав
   1 сьогодні	тримає
   1 сьогодні	мабуть
   1 сучасної	людини
   1 рухатися	вперед
   1 продавця	овочів
   1 політика	знайти
   1 небідною	Батько
   1 молодшим	братом
   1 культура	Вацлав
   1 кругової	поруки
   1 ключових	творів
   1 звичайно	значно
   1 господах	Згодом
   1 відчуття	власно
   1 відчуття	Вацлав
   1 відверто	уникає
   1 виводить	просте
   1 важливий	діалог
   1 безсилих	Вацлав
   1 архівної	справи
   1 ДАЙДЖЕСТ	ІНТЕРВ
   1 Бондарук	Дмитро
   1 єднувала	чехів
   1 цікавить	особа
   1 техніком	сцени
   1 сумління	Гавел
   1 політики	життя
   1 повстане	проти
   1 отримала	назву
   1 називали	якусь
   1 ключових	ролей
   1 запрошує	іншим
   1 декілька	разів
   1 водночас	ціллю
   1 важливим	Такий
   1 безсилих	Гавел
   1 Звичайно	Гавел
   1 Дивіться	також
   1 Галичини	виник
   1 Брєжнєва	разом
   1 єктності	Саме
   1 ситуації	якою
   1 простору	Силу
   1 політика	який
   1 перестає	бути
   1 наслідки	його
   1 молодому	віці
   1 магазині	хоче
   1 лозунгах	Жити
   1 золотого	віку
   1 зазвичай	коли
   1 вручення	йому
   1 видалося	йому
   1 безсилих	Фото
   1 Продавця	який
   1 Вузловим	стає
   1 єднатися	він
   1 уявлення	про
   1 таблички	Тим
   1 сьогодні	він
   1 стаються	для
   1 системою	Міф
   1 роздумує	над
   1 репресії	Він
   1 психушка	Нью
   1 простору	для
   1 політику	Але
   1 політика	Дві
   1 особиста	Він
   1 керівних	рис
   1 житимемо	тут
   1 говорить	про
   1 відчуття	він
   1 виставку	про
   1 Гендрікс	рух
   1 Водночас	цей
   1 Водночас	для
   1 Америкою	був
   1 ятровичу	на
   1 фальшива	що
   1 тюремних	ув
   1 табличку	То
   1 сьогодні	об
   1 схильним	до
   1 сутність	ми
   1 словаків	та
   1 репресій	та
   1 прогресу	та
   1 правилам	Це
   1 портфеля	за
   1 побачать	що
   1 очевидно	що
   1 концерту	до
   1 залежить	на
   1 завідомо	не
   1 відчуття	це
   1 відсутнє	це
   1 впливала	на
   1 впевнена	що
   1 водночас	не
   1 виходили	на
   1 виражені	чи
   1 агітував	за
   1 Політика	та
   1 Масарика	та
   1 Масарика	на
   1 усувають	з
   1 таємниці	і
   1 табличок	в
   1 табличку	з
   1 сутність	і
   1 сумління	в
   1 ставлять	в
   1 продавця	є
   1 проблема	в
   1 прийняли	з
   1 переможе	а
   1 написані	в
   1 навчання	у
   1 квитками	В
   1 знайомий	з
   1 зламався	і
   1 громадян	в
   1 головним	в
   1 гвинтика	в
   1 вулицями	з
   1 вмістити	в
   1 безсилих	і
   1 акаунтом	у
   1 Щоправда	в
   1 Водночас	і
   1 ПОЛІТИКА	RSS
   1 поручнях	Na
   1 мистецтв	FAMU
   1 сумління	941a97a
   1 культури	93e096e
   1 Вершиною	60
   1 окупації	1968
   1 Поняття	відповідальності
   1 ділянці	державотворення
   1 театрах	Чехословаччини
   1 питання	співрозмовнику
   1 поняття	пролетарської
   1 останні	парламентські
   1 нечасто	висловлювався
   1 захисту	несправедливо
   1 доктора	Гарвардського
   1 Гавелом	екзистенційно
   1 позиція	балансування
   1 певного	внутрішнього
   1 спротив	радянському
   1 пройшла	Повернімося
   1 природу	заздалегідь
   1 приклад	включеності
   1 місяців	позбавлення
   1 залюбки	посилається
   1 жодного	угрупування
   1 відомим	журналістом
   1 впливом	католицизму
   1 власним	визначенням
   1 богемою	поширюються
   1 якомусь	офіційному
   1 страйку	робітників
   1 системі	технічного
   1 прийняв	католицизм
   1 починає	опозиційні
   1 повинні	поводитися
   1 називав	незалежним
   1 можливо	заставлять
   1 видимим	горизонтом
   1 Пушкіну	вшанувавши
   1 Америка	залишиться
   1 філософ	мислитель
   1 учасник	повстання
   1 течіями	всередині
   1 текстах	релігійні
   1 ступеня	почесного
   1 свободу	творчості
   1 різними	сторонами
   1 починає	працювати
   1 повинна	перемогти
   1 повинна	очікувати
   1 питання	наприклад
   1 певного	чуттєвого
   1 написом	Пролетарі
   1 виконує	потрібний
   1 вагання	оплачуємо
   1 Родинна	атмосфера
   1 Майклом	Джексоном
   1 Людська	поведінка
   1 історія	звичайно
   1 історію	архівної
   1 єктивні	відчуття
   1 яскраво	виражені
   1 столиці	Галичини
   1 справді	важливим
   1 причину	загибелі
   1 природи	Водночас
   1 західна	культура
   1 залишає	простору
   1 вітрині	власного
   1 втрачає	відчуття
   1 власної	життєвої
   1 власним	висловом
   1 будинок	Звичайно
   1 КОЛОНКИ	ДАЙДЖЕСТ
   1 єдності	системи
   1 ясували	причину
   1 якомусь	джерелі
   1 успішно	покинув
   1 сумніву	західна
   1 сторона	питання
   1 систему	державу
   1 світове	полотно
   1 різними	течіями
   1 прогрес	нівелює
   1 починає	словами
   1 порушив	правила
   1 звучить	жорстко
   1 життєва	історія
   1 джерелі	джерелі
   1 галереї	Останні
   1 відомий	учасник
   1 КОРОТКО	КОЛОНКИ
   1 Вахтанг	Кіпіані
   1 Історія	Вацлава
   1 історії	Вацлав
   1 історія	відома
   1 частину	маєтку
   1 судовий	процес
   1 систему	Звідси
   1 природу	Мовляв
   1 повинні	робити
   1 повинна	чинити
   1 площину	людина
   1 питання	Вацлав
   1 набуває	цілком
   1 масових	жестах
   1 крикнув	Король
   1 жорстко	Людина
   1 дружину	Вацлав
   1 втрачає	власну
   1 власних	правил
   1 висилає	сигнал
   1 апріорі	тонкий
   1 Сучасна	людина
   1 Останні	тексти
   1 Зелених	Партія
   1 Густава	Гусака
   1 Гашомер	Гацаїр
   1 ГОЛОВНА	ТЕКСТИ
   1 частину	життя
   1 частина	цього
   1 справді	вплив
   1 способу	життя
   1 системі	Цього
   1 систему	Гавел
   1 політик	лідер
   1 платити	штраф
   1 певному	сенсі
   1 околиць	міста
   1 образом	цього
   1 маминій	лінії
   1 конкурс	есеїв
   1 колегам	ВІДЕО
   1 кожному	кроці
   1 ключове	життя
   1 значною	мірою
   1 джерелі	буття
   1 джерело	буття
   1 гавліст	набув
   1 відмови	брати
   1 Холодна	війна
   1 Коротко	Вчені
   1 Дрібної	праці
   1 Генерал	Петро
   1 Історія	котра
   1 ІСТОРІЯ	БЛОГИ
   1 язничне	фото
   1 утискам	було
   1 успіхів	Його
   1 словами	Наша
   1 система	пост
   1 підкаже	коли
   1 причини	свої
   1 початку	літа
   1 посідає	одну
   1 полягає	наша
   1 полотно	Тому
   1 покинув	межі
   1 повинні	жити
   1 останні	роки
   1 нівелює	наші
   1 збірної	ЧССР
   1 запитує	свою
   1 загалом	Така
   1 друзями	пише
   1 випадку	ядро
   1 Рейгана	Інші
   1 Клінтон	грав
   1 історії	поп
   1 історія	про
   1 спільне	між
   1 системі	діє
   1 системі	Цим
   1 сильним	був
   1 релігій	Але
   1 прожило	під
   1 позиція	від
   1 позиція	Цей
   1 позицію	над
   1 модерує	він
   1 книжкою	під
   1 ключове	для
   1 дрібних	але
   1 відміну	від
   1 будував	кар
   1 активна	дія
   1 Справді	сім
   1 Система	яка
   1 Комітет	для
   1 історія	що
   1 ідеалом	то
   1 шухляду	На
   1 сумніву	це
   1 створив	он
   1 скепсис	по
   1 розуміє	що
   1 проїзді	ми
   1 природу	Це
   1 природи	до
   1 правило	Ми
   1 пояснює	що
   1 пояснює	цю
   1 поштовх	до
   1 посягає	на
   1 поняття	на
   1 погляди	на
   1 повинні	об
   1 питання	Ми
   1 охопити	чи
   1 королів	та
   1 комедії	до
   1 кожного	на
   1 зловити	на
   1 джерела	та
   1 говорив	що
   1 відомим	що
   1 виступу	на
   1 виступи	та
   1 байдуже	чи
   1 Прогрес	об
   1 ЛуРідом	та
   1 Гавелом	та
   1 Америка	на
   1 Ізраїлю	не
   1 системи	і
   1 процеси	І
   1 промови	з
   1 полягає	в
   1 позицію	в
   1 подорож	в
   1 містком	в
   1 критики	В
   1 ключове	у
   1 зростав	в
   1 значним	Р
   1 забутим	і
   1 діалогу	В
   1 державу	І
   1 відомих	у
   1 відомим	в
   1 вчилися	в
   1 вистави	в
   1 виборах	і
   1 аналога	Л
   1 абсурду	В
   1 Естрада	і
   1 Головна	ж
   1 Америку	у
   1 Америки	В
   1 мережах	ico01
   1 виразно	d95acc5
   1 Кіпіані	INS
   1 Україні	28
   1 початку	1989
   1 Трутнов	1974
   1 Бандеру	04
   1 світом	Відповідальність
   1 завжди	Відповідальність
   1 власну	індивідуальність
   1 умовах	соціалістичного
   1 всього	пострадянського
   1 видань	гіперпосиланням
   1 Гусака	чехословацького
   1 творів	дисидентського
   1 період	соціалістичної
   1 зразок	громадянського
   1 тиском	громадськості
   1 термін	артикульоване
   1 спроба	філософського
   1 правил	приватизувати
   1 людини	Середньовіччя
   1 цілком	кантіанських
   1 правда	Використання
   1 одразу	задумувалися
   1 тримає	голодування
   1 родина	піддавалася
   1 погано	закінчиться
   1 першим	президентом
   1 мотиви	проступають
   1 значно	кориснішими
   1 життям	суспільства
   1 батько	подорожував
   1 Партія	провалилася
   1 Звідси	починається
   1 Дмитро	Яворницький
   1 Батько	майбутнього
   1 тексти	Єврейський
   1 стаємо	гвинтиками
   1 просто	мисленнєва
   1 правді	активістів
   1 посаді	президента
   1 першої	республіки
   1 першої	буржуазної
   1 очолив	Оксамитову
   1 основа	світогляду
   1 навіть	найменшими
   1 кшталт	абсолютний
   1 згодом	називатиме
   1 займає	центральну
   1 займає	нейтральну
   1 власно	важливості
   1 Львові	народилися
   1 Гавела	драматурга
   1 цілком	очевидним
   1 ритуал	висловлює
   1 нічого	спільного
   1 назвою	Протоколи
   1 надалі	працювати
   1 людина	забруднює
   1 значно	складніша
   1 знайти	консенсус
   1 гуляли	празькими
   1 більше	вдячності
   1 Хартії	створюють
   1 Мокрик	науковець
   1 Людина	перебирає
   1 Гавела	поступово
   1 Євгена	Сверстюка
   1 ЄВРОПА	ЕКОНОМІКА
   1 чинити	сумління
   1 цілком	особиста
   1 тексті	Політика
   1 спершу	останнім
   1 своєму	магазині
   1 правил	потрібно
   1 овочів	Продавця
   1 надією	українці
   1 нагоди	вручення
   1 манері	роздумує
   1 людина	впевнена
   1 знайти	найменше
   1 відділ	місцевої
   1 будуть	репресії
   1 Цілком	очевидно
   1 Сенцов	сьогодні
   1 Москва	психушка
   1 Джиммі	Гендрікс
   1 Гавела	Водночас
   1 ілюзію	єдності
   1 ятника	Пушкіну
   1 термін	гавліст
   1 театру	абсурду
   1 робота	кожного
   1 підчас	промови
   1 просто	повинна
   1 просте	правило
   1 правда	ГОЛОВНА
   1 першої	вистави
   1 партію	Зелених
   1 навіть	власної
   1 людина	систему
   1 людина	втрачає
   1 згідно	власних
   1 власні	джерела
   1 ТЕКСТИ	КОРОТКО
   1 Гавела	система
   1 Гавела	полягає
   1 Гавела	набуває
   1 Гавела	звучить
   1 язниці	Врешті
   1 чинить	згідно
   1 чинити	згідно
   1 травні	червні
   1 своїми	навіть
   1 правді	навіть
   1 можете	увійти
   1 маєтку	дядька
   1 мабуть	більше
   1 кроком	робите
   1 змінює	людину
   1 згодом	першим
   1 діалог	вміння
   1 голого	короля
   1 вміння	знайти
   1 вагань	назвав
   1 братом	Іваном
   1 Таврія	Москва
   1 Мокрик	Версія
   1 Мовляв	дитина
   1 Людина	просто
   1 Забули	пароль
   1 Дрібна	робота
   1 Гацаїр	Десять
   1 Гавела	триває
   1 Гавела	термін
   1 іншими	Мілош
   1 чимось	вищим
   1 цілому	світу
   1 успіху	вдома
   1 уникає	цього
   1 сигнал	іншим
   1 самому	кінці
   1 правді	Тобто
   1 правді	Логін
   1 період	Гавел
   1 нічого	окрім
   1 навіть	таким
   1 межами	Чехії
   1 змінює	людей
   1 згодом	Мілош
   1 діалог	стане
   1 дядько	Мілош
   1 дрібна	праця
   1 вибори	треба
   1 Стоунз	Прага
   1 Листах	Ользі
   1 Король	голий
   1 Гавела	знову
   1 Гавела	Листи
   1 Гавела	Гавел
   1 єднань	його
   1 хлопця	який
   1 роботі	пише
   1 робите	свій
   1 просто	тому
   1 прожив	своє
   1 правді	Таке
   1 надією	Олег
   1 лозунг	Жити
   1 країни	який
   1 завжди	несе
   1 діалог	Саме
   1 дядька	який
   1 вчинок	яким
   1 Хартії	тоді
   1 Хартії	Саме
   1 Заходу	його
   1 Десять	слів
   1 Гавела	якщо
   1 Гавела	який
   1 Гавела	стає
   1 Гавела	його
   1 Гавела	дуже
   1 Гавела	Сила
   1 уявити	яке
   1 увійти	під
   1 травні	під
   1 тонкий	лід
   1 справа	під
   1 робить	Він
   1 робити	всі
   1 робити	все
   1 процес	над
   1 просто	він
   1 правил	гри
   1 правді	має
   1 правді	він
   1 правду	ПРО
   1 народу	Міф
   1 моралі	при
   1 людину	яка
   1 людина	яка
   1 людина	має
   1 людина	або
   1 листів	він
   1 листах	він
   1 кричав	про
   1 короля	але
   1 діалог	між
   1 довший	час
   1 грудні	він
   1 вибори	при
   1 Стоунз	які
   1 Мовляв	він
   1 Гавела	сім
   1 Гавела	був
   1 Врешті	міф
   1 Власне	вже
   1 Версія	для
   1 Бенеша	Міф
   1 язнень	за
   1 ходити	не
   1 триває	До
   1 театрі	На
   1 прямує	до
   1 проїзд	Як
   1 причин	на
   1 правді	це
   1 правді	та
   1 період	ув
   1 партію	не
   1 пароль	що
   1 пароль	Ви
   1 нічого	не
   1 назвав	би
   1 навіть	не
   1 навіть	до
   1 мораль	це
   1 людина	не
   1 країна	не
   1 квиток	не
   1 зуміти	на
   1 знятих	із
   1 жестах	Це
   1 дитини	та
   1 вперед	Ця
   1 вибори	не
   1 вважає	за
   1 більше	що
   1 більше	за
   1 брехні	Це
   1 брехню	та
   1 Чогось	що
   1 Форман	чи
   1 Згодом	на
   1 Гавела	чи
   1 Гавела	це
   1 Гавела	по
   1 Гавела	не
   1 Гавела	До
   1 Європи	та
   1 іншого	а
   1 язненя	В
   1 участь	у
   1 участь	в
   1 термін	Т
   1 театрі	В
   1 табору	Р
   1 служби	в
   1 символ	і
   1 роботи	в
   1 поруки	І
   1 перший	в
   1 одразу	ж
   1 одному	з
   1 навіть	у
   1 навіть	в
   1 мораль	в
   1 людину	а
   1 людини	в
   1 книжки	В
   1 дитина	і
   1 вірить	в
   1 військ	у
   1 вибори	і
   1 більше	в
   1 Правда	і
   1 Майдан	і
   1 Звідси	і
   1 Гавела	і
   1 Гавела	а
   1 Вацлав	М
   1 Батько	з
   1 Іваном	М
   1 ІНТЕРВ	Ю
   1 ЗНАЙТИ	____________________
   1 Пароль	X
   1 групою	Plastic
   1 відома	80
   1 Дніпра	24
   1 режиму	1989
   1 Гавела	1980
   1 язниці	1979
   1 кінець	1970
   1 червні	1968
   1 ВОЛИНЬ	1943
   1 жовтні	1936
   1 Бенеша	0fb3aa7
   1 Гавела	06
   1 Аккаду	05
   1 справи	04
   1 ТАБЛОID	ЖИТТЯ
   1 вищої	відповідальності
   1 ютері	УВІЙТИВІДМІНИТИ
   1 темою	Чехословаччина
   1 своєї	екзистенційної
   1 ласка	зареєструйтесь
   1 Після	комуністичного
   1 чітку	екзистенційну
   1 листа	інтелектуалів
   1 життя	Альтернативою
   1 єднує	прихильників
   1 зміна	відбувається
   1 вплив	католицького
   1 Гавел	використовує
   1 шукав	компромісів
   1 цього	залишається
   1 фінал	оксамитової
   1 сфері	будівництва
   1 проти	маніпуляції
   1 першу	літературну
   1 лінії	УгоВавречка
   1 лідер	Оксамитової
   1 любив	повторювати
   1 життя	починається
   1 добре	завершиться
   1 вищим	залишається
   1 Гавел	перебільшує
   1 Гавел	організовує
   1 Гавел	зустрічався
   1 Гавел	знаходиться
   1 часто	становлять
   1 цьому	побудувати
   1 усіма	дефіцитами
   1 таким	невеличким
   1 роком	народження
   1 особа	громадянин
   1 кожен	поважаючий
   1 знову	затримують
   1 всіма	напрямками
   1 вести	аполітичну
   1 Празі	кіностудій
   1 Петро	Григоренко
   1 Граді	історичній
   1 Гавел	письменник
   1 інших	продавців
   1 єднує	гавлістів
   1 щодня	виставляє
   1 сайту	дозволено
   1 надає	відповіді
   1 міста	Паневежис
   1 країн	єднайтеся
   1 зумів	досягнути
   1 групи	складають
   1 вкрай	практичні
   1 вибір	набуваєте
   1 Якесь	невловиме
   1 Чехія	соціалізм
   1 Такий	продавець
   1 Проте	здавалося
   1 Празі	виступали
   1 Гавел	стверджує
   1 Гавел	проводить
   1 Гавел	народився
   1 Гавел	залишився
   1 Гавел	відслужив
   1 Гавел	впевнений
   1 їдемо	трамваєм
   1 цього	відчуття
   1 твори	ставлять
   1 твори	виходять
   1 також	тримають
   1 стане	головним
   1 світі	осередок
   1 своїм	акаунтом
   1 окрім	репресій
   1 мірою	впливала
   1 людей	повстане
   1 криза	сучасної
   1 зумів	вмістити
   1 життя	справляє
   1 життя	продавця
   1 епоху	золотого
   1 вибір	Водночас
   1 Після	окупації
   1 Помер	останній
   1 Пласт	скаутинг
   1 Листи	написані
   1 Гавел	порівнює
   1 Гавел	дисидент
   1 Гавел	відверто
   1 іншим	образом
   1 єднує	Історія
   1 якесь	світове
   1 цьому	випадку
   1 цього	питання
   1 також	полягає
   1 таких	дрібних
   1 сліди	яскраво
   1 своїй	ділянці
   1 самих	текстах
   1 режим	Справді
   1 після	певного
   1 нього	скепсис
   1 назву	Гашомер
   1 любов	повинна
   1 країн	повинні
   1 колах	починає
   1 задає	питання
   1 життя	прожило
   1 голий	порушив
   1 більш	відомим
   1 архів	створив
   1 Тобто	позиція
   1 Тобто	активна
   1 Надто	сильним
   1 ЖИТТЯ	ІСТОРІЯ
   1 Гавел	прийняв
   1 Гавел	нечасто
   1 Гавел	називав
   1 Гавел	залюбки
   1 Гавел	говорив
   1 Гавел	Людська
   1 ВІДЕО	Естрада
   1 треба	ходити
   1 свого	народу
   1 самих	листах
   1 проте	згодом
   1 праці	термін
   1 писав	Хартію
   1 перед	чимось
   1 перед	світом
   1 нього	Вацлав
   1 назви	одного
   1 місті	Львові
   1 кроці	кричав
   1 знову	стаємо
   1 житті	Гавела
   1 жанрі	театру
   1 думку	Гавела
   1 вести	діалог
   1 брати	участь
   1 ФОРУМ	ЄВРОПА
   1 Союзу	участь
   1 Мілош	Форман
   1 Логін	Пароль
   1 Гавел	справа
   1 Гавел	символ
   1 Вирок	Гавела
   1 Бітлз	Джиммі
   1 інших	країн
   1 іншим	грати
   1 якого	Гавел
   1 цьому	також
   1 цьому	слові
   1 цього	слова
   1 хтось	інший
   1 також	Листи
   1 слові	Надто
   1 сенсі	слова
   1 сенсі	Гавел
   1 самій	Чехії
   1 різні	назви
   1 разом	усіма
   1 пізні	Бітлз
   1 площі	Прага
   1 новий	читач
   1 несла	назву
   1 котра	свого
   1 зараз	Колаж
   1 життя	Гавел
   1 група	людей
   1 війна	Чехія
   1 волею	свого
   1 вкрай	різні
   1 буття	Листи
   1 Чехії	волею
   1 Після	цього
   1 Проте	Гавел
   1 Пласт	Однак
   1 Листи	Ользі
   1 Запам	ятати
   1 Гавел	разом
   1 Гавел	писав
   1 Гавел	любив
   1 Гавел	зумів
   1 Гавел	задає
   1 Гавел	Надія
   1 Гавел	Епоха
   1 Богом	Проте
   1 БЛОГИ	ФОРУМ
   1 існує	лише
   1 якусь	вищу
   1 читач	будь
   1 цьому	комп
   1 цьому	віці
   1 цього	часу
   1 цього	разу
   1 хтось	один
   1 своїй	тезі
   1 свого	часу
   1 різні	люди
   1 після	того
   1 невід	ємна
   1 народ	його
   1 набув	ледь
   1 знову	його
   1 голос	який
   1 важко	собі
   1 буття	ніби
   1 армії	Фото
   1 Цього	разу
   1 Після	того
   1 Ольго	чому
   1 Ольги	Фото
   1 Однак	досі
   1 Колаж	ФОТО
   1 Гавел	таки
   1 Гавел	став
   1 Гавел	кіно
   1 Гавел	буде
   1 Гавел	Люба
   1 ВІДЕО	Чехи
   1 іншим	гра
   1 інший	без
   1 якого	йде
   1 ціллю	для
   1 тюрмі	всі
   1 тюрмі	Тут
   1 треба	ітд
   1 слова	міф
   1 світу	Міф
   1 самим	він
   1 разів	був
   1 після	цих
   1 місця	Усі
   1 клубі	Без
   1 зможе	нас
   1 есеїв	Сто
   1 дідом	Уго
   1 думає	про
   1 групі	але
   1 групу	яка
   1 бачив	цей
   1 армії	він
   1 Чехії	ніж
   1 Ользі	які
   1 Левко	Лук
   1 Епоха	яка
   1 Гавел	під
   1 Гавел	про
   1 Гавел	був
   1 ятати	на
   1 якраз	на
   1 якого	аж
   1 чутки	що
   1 часом	чи
   1 танки	на
   1 схоже	на
   1 слова	ба
   1 сенси	що
   1 світу	до
   1 років	та
   1 помер	за
   1 одній	чи
   1 одним	із
   1 ніхто	не
   1 назву	за
   1 людей	на
   1 ложах	та
   1 країн	чи
   1 країн	та
   1 комин	ще
   1 дійти	до
   1 віриш	це
   1 буття	що
   1 буття	це
   1 Чехії	На
   1 Надія	це
   1 Листи	до
   1 Гавел	що
   1 Гавел	та
   1 Гавел	Це
   1 Бітлз	та
   1 єднує	і
   1 янеко	у
   1 якось	є
   1 штраф	а
   1 чехів	і
   1 цьому	є
   1 усіма	і
   1 тюрмі	В
   1 тисяч	і
   1 сцени	в
   1 ролей	І
   1 режим	в
   1 разом	з
   1 праця	і
   1 подій	у
   1 нехай	і
   1 надії	і
   1 надія	я
   1 людей	а
   1 крила	в
   1 комин	і
   1 комин	з
   1 книги	В
   1 життя	В
   1 грати	в
   1 війни	і
   1 виник	і
   1 вдома	і
   1 Ользі	В
   1 Листи	з
   1 Життя	в
   1 Гавел	і
   1 Гавел	ж
   1 Гавел	в
   1 Вчені	з
   1 друку	f8b4e34
   1 ШАЛОМ	INT
   1 кінці	50
   1 січня	1990
   1 Прага	1990
   1 кінці	1989
   1 зірок	1968
   1 Праги	1968
   1 Прага	1968
   1 гетто	02
   1 несе	відповідальність
   1 наша	відповідальність
   1 лише	закомпостованими
   1 Така	відповідальність
   1 межі	соціалістичного
   1 ядро	громадянського
   1 віку	Чехословаччини
   1 Теми	Чехословаччина
   1 пост	тоталітарного
   1 його	президентства
   1 ніби	продовженням
   1 йому	неправильним
   1 його	світоглядній
   1 віці	проявляється
   1 став	президентом
   1 свої	переконання
   1 року	напередодні
   1 пише	здебільшого
   1 одну	організацію
   1 нами	спостерігає
   1 його	відпускають
   1 боку	вимагається
   1 Чехи	відмовилися
   1 який	пропагував
   1 шлях	суспільних
   1 теми	Характерно
   1 році	підписанти
   1 межі	природного
   1 кіно	продюсером
   1 його	драматичні
   1 який	народився
   1 який	намагався
   1 собі	відводить
   1 сенс	незалежно
   1 свої	пояснення
   1 свої	обставини
   1 своє	виживання
   1 роки	міністром
   1 роки	майбутній
   1 пише	статтіпро
   1 його	передусім
   1 його	мотивація
   1 його	зрозуміла
   1 десь	цілковито
   1 веде	розповідь
   1 бути	гвинтиком
   1 було	відібрано
   1 була	непростою
   1 Емір	Кустуріца
   1 Інші	матеріали
   1 якій	ситуації
   1 який	декілька
   1 чому	зазвичай
   1 тоді	видалося
   1 таки	відкрито
   1 стає	останнім
   1 сила	безсилих
   1 роль	гвинтика
   1 роки	стаються
   1 ніби	житимемо
   1 лайн	виставку
   1 його	словесні
   1 жест	продавця
   1 дуже	важливий
   1 вона	перестає
   1 волі	Щоправда
   1 вищу	сутність
   1 ЧССР	мстяться
   1 Силі	безсилих
   1 Силу	безсилих
   1 Сили	безсилих
   1 Леся	Бондарук
   1 ємна	частина
   1 який	будував
   1 часу	Америка
   1 таки	успішно
   1 стає	подорож
   1 себе	філософ
   1 світ	загалом
   1 свою	дружину
   1 один	крикнув
   1 люди	систему
   1 лише	виконує
   1 йому	ступеня
   1 його	позиція
   1 діти	вчилися
   1 дуже	певного
   1 дуже	виразно
   1 досі	забутим
   1 всім	байдуже
   1 Тому	повинні
   1 Далі	історія
   1 Білл	Клінтон
   1 ідеї	першої
   1 якою	Вацлав
   1 яким	людина
   1 який	прожив
   1 який	очолив
   1 який	вчинок
   1 щось	більше
   1 чому	мораль
   1 цією	надією
   1 форм	мораль
   1 тезі	Вацлав
   1 теза	Гавела
   1 суті	одразу
   1 став	спершу
   1 собі	уявити
   1 себе	манері
   1 саме	звідси
   1 року	родина
   1 року	Звідси
   1 року	Гавела
   1 пише	Хартію
   1 ніби	людина
   1 мене	нічого
   1 його	роботи
   1 його	правил
   1 його	першої
   1 його	батько
   1 веде	діалог
   1 були	значно
   1 буде	робити
   1 ФОТО	знятих
   1 Свій	лозунг
   1 Саме	звідси
   1 Саме	діалог
   1 Олег	Сенцов
   1 Наша	країна
   1 який	щодня
   1 ядро	групи
   1 щось	добре
   1 собі	сліди
   1 світ	існує
   1 свій	вибір
   1 свої	сенси
   1 року	Після
   1 роки	життя
   1 роки	Гавел
   1 пише	Листи
   1 небо	Гавел
   1 мало	вкрай
   1 люди	часто
   1 комп	ютері
   1 джаз	клубі
   1 віці	зумів
   1 будь	ласка
   1 Таке	життя
   1 Саме	після
   1 Люба	Ольго
   1 Його	твори
   1 який	тобі
   1 який	стає
   1 щось	тоді
   1 часи	його
   1 того	коли
   1 себе	роль
   1 себе	вона
   1 роль	Бога
   1 року	Фото
   1 року	ФОТО
   1 разі	якщо
   1 пише	один
   1 пили	пиво
   1 може	бути
   1 лише	тому
   1 його	діти
   1 його	боку
   1 бути	будь
   1 була	ніби
   1 будь	якій
   1 будь	який
   1 Юрій	Юзич
   1 ФОТО	Сила
   1 їзді	або
   1 якщо	він
   1 який	сам
   1 який	дає
   1 хоче	щоб
   1 тоді	всі
   1 того	чим
   1 тобі	сам
   1 тези	про
   1 стає	все
   1 собі	був
   1 саме	тим
   1 руху	для
   1 році	він
   1 року	він
   1 прем	єра
   1 наші	суб
   1 люди	від
   1 веде	або
   1 будь	яка
   1 Чому	він
   1 Тому	для
   1 Київ	під
   1 якщо	не
   1 який	на
   1 щось	за
   1 часу	об
   1 хіпі	та
   1 факт	що
   1 тоді	на
   1 того	як
   1 того	що
   1 того	чи
   1 стає	на
   1 смог	це
   1 себе	не
   1 світ	та
   1 самі	ім
   1 саме	ці
   1 русі	це
   1 року	це
   1 разу	це
   1 ніяк	не
   1 коли	ми
   1 йому	не
   1 його	не
   1 грав	на
   1 будь	що
   1 буде	до
   1 Якщо	ви
   1 якою	б
   1 який	в
   1 чому	б
   1 цією	ж
   1 хіпі	А
   1 хоче	і
   1 фото	В
   1 стає	в
   1 себе	і
   1 самі	і
   1 руху	в
   1 році	в
   1 року	в
   1 року	а
   1 разу	в
   1 пиво	в
   1 одну	з
   1 одна	з
   1 один	з
   1 несе	в
   1 лише	з
   1 коли	і
   1 коли	в
   1 жити	в
   1 волю	А
   1 бунт	і
   1 УРСС	З
   1 Тоді	в
   1 Бога	і
   1 Фото	zakleteknihy
   1 Фото	mapa
   1 Фото	kultura
   1 Фото	brno
   1 Фото	blesk
   1 Фото	Concurring
   1 Фото	Bigmir
   1 Фото	Antikvariat
   1 Юзич	36677ef
   1 Йорк	21
   1 стає	1976
   1 літа	1968
   1 ФОТО	1968
   1 Але	відповідальність
   1 ПРО	ПРОЕКТЗВОРОТНІЙ
   1 гра	продовжується
   1 від	встановленого
   1 для	наслідування
   1 для	коментування
   1 Він	повертається
   1 яка	намагається
   1 для	особистості
   1 він	полемізуючи
   1 був	підприємцем
   1 був	арештованим
   1 але	впевненість
   1 Для	авторизації
   1 про	соборність
   1 дає	можливість
   1 він	впроваджує
   1 був	лояльніший
   1 яка	перемогла
   1 яка	здавалася
   1 цей	технічний
   1 хто	допомагає
   1 тут	спільного
   1 тим	чоловіком
   1 так	правильно
   1 під	державним
   1 ніж	всередині
   1 дає	відповідь
   1 від	реформних
   1 все	справляло
   1 або	принаймні
   1 Яна	Тимошенко
   1 Цей	світогляд
   1 Уго	Вавречкою
   1 Він	підтримує
   1 Але	передусім
   1 яке	враження
   1 яка	отримала
   1 час	празькою
   1 суб	єктності
   1 рок	концерту
   1 під	суттєвим
   1 про	продавця
   1 про	політика
   1 про	молодого
   1 неї	відсутнє
   1 має	уявлення
   1 для	інтернет
   1 для	побудови
   1 гра	фальшива
   1 гра	кругової
   1 всі	побачать
   1 ваш	кандидат
   1 був	схильним
   1 був	особисто
   1 без	портфеля
   1 але	водночас
   1 Для	молодого
   1 яка	життєва
   1 тут	посідає
   1 тут	погляди
   1 суб	єктивні
   1 сам	підкаже
   1 під	поняття
   1 про	історію
   1 про	спротив
   1 про	Бандеру
   1 нас	можливо
   1 нас	зловити
   1 для	критики
   1 для	захисту
   1 для	Вацлава
   1 дає	поштовх
   1 він	пояснює
   1 він	посягає
   1 він	модерує
   1 він	запитує
   1 він	втрачає
   1 від	відмови
   1 всі	питання
   1 бік	жодного
   1 був	значним
   1 був	відомим
   1 був	апріорі
   1 без	сумніву
   1 але	масових
   1 Усі	галереї
   1 Міф	Вацлава
   1 Дві	історії
   1 Він	розуміє
   1 Без	сумніву
   1 які	гуляли
   1 яке	значну
   1 яка	чинить
   1 час	служби
   1 час	нічого
   1 цей	період
   1 тут	завжди
   1 тим	більше
   1 рок	групою
   1 рис	Гавела
   1 під	тиском
   1 під	назвою
   1 про	хлопця
   1 про	людину
   1 про	голого
   1 про	Євгена
   1 пам	ятника
   1 неї	погано
   1 між	іншими
   1 має	нічого
   1 має	власні
   1 діє	згідно
   1 дія	Вацлав
   1 для	всього
   1 дим	Мовляв
   1 він	навіть
   1 без	вагань
   1 але	довший
   1 або	навіть
   1 Про	вибори
   1 Міф	Гавела
   1 які	також
   1 яка	несла
   1 щоб	хтось
   1 час	війни
   1 час	Гавел
   1 цій	надії
   1 цих	подій
   1 тих	самих
   1 ряд	тисяч
   1 під	своїм
   1 про	народ
   1 при	житті
   1 поп	зірок
   1 над	іншим
   1 над	усіма
   1 між	всіма
   1 має	чітку
   1 лід	Після
   1 для	людей
   1 для	друку
   1 він	бачив
   1 від	листа
   1 все	якось
   1 все	більш
   1 або	група
   1 Тим	самим
   1 Сам	Гавел
   1 Лук	янеко
   1 єра	його
   1 яка	була
   1 щоб	його
   1 час	його
   1 теж	мало
   1 так	ніби
   1 сам	собі
   1 рік	Фото
   1 рік	Тоді
   1 рух	хіпі
   1 при	чому
   1 для	себе
   1 він	таки
   1 він	стає
   1 він	буде
   1 від	мене
   1 всі	його
   1 всі	Тому
   1 все	своє
   1 був	саме
   1 Сто	слів
   1 Нью	Йорк
   1 Він	хоче
   1 Він	несе
   1 цей	час
   1 той	хто
   1 сам	дає
   1 сам	був
   1 сам	Бог
   1 над	рок
   1 міф	про
   1 міф	Міф
   1 кар	єру
   1 йде	дим
   1 для	неї
   1 він	той
   1 він	сам
   1 від	рок
   1 від	пам
   1 все	має
   1 але	сам
   1 Цим	він
   1 Тут	він
   1 Ось	тут
   1 Він	сам
   1 Але	Міф
   1 ітд	за
   1 єру	на
   1 які	ти
   1 які	по
   1 чим	це
   1 цей	же
   1 сам	по
   1 про	це
   1 про	те
   1 нас	об
   1 міф	як
   1 він	це
   1 він	об
   1 він	не
   1 всі	ці
   1 все	що
   1 але	не
   1 США	та
   1 Він	не
   1 Бог	чи
   1 рік	у
   1 ніж	у
   1 гри	і
   1 гри	а
   1 гри	І
   1 він	з
   1 але	й
   1 Міф	в
   1 Дід	В
   1 гру	3a8dd2d
   1 вже	1990
   1 КГБ	1969
   1 цю	відповідальність
   1 Ця	відповідальність
   1 та	геронтократією
   1 та	американською
   1 не	найголовнішій
   1 не	найважливішою
   1 за	президентства
   1 до	інституційний
   1 чи	внутрішнього
   1 не	підкоряється
   1 на	безбілетному
   1 до	студентської
   1 Це	відчувається
   1 із	засновників
   1 що	впорядковує
   1 чи	безнадійною
   1 це	завершиться
   1 це	забруднення
   1 та	український
   1 та	президентів
   1 та	заручниками
   1 не	романтичних
   1 не	подобається
   1 не	переконання
   1 не	обмежується
   1 на	суспільство
   1 на	веберівське
   1 на	абсолютному
   1 на	Українській
   1 на	Вацлавській
   1 за	суспільство
   1 до	католицьких
   1 до	голодування
   1 На	батьківщині
   1 На	Прикарпатті
   1 ЗВ	ЯЗОКРЕКЛАМА
   1 До	геніального
   1 що	характерно
   1 що	демократію
   1 чи	усвідомити
   1 це	підкорення
   1 це	внутрішній
   1 та	історичним
   1 та	сексуальна
   1 та	дипломатом
   1 та	встановлює
   1 по	відношенню
   1 не	іронічного
   1 не	найбільших
   1 не	автентичне
   1 до	відвертого
   1 НА	САЙТІАРХІВ
   1 її	особистий
   1 як	правильно
   1 як	картковий
   1 що	пролетарі
   1 що	правлячий
   1 що	насправді
   1 що	найбільша
   1 це	фабричний
   1 це	поставити
   1 це	Продавець
   1 то	принаймні
   1 та	ненависть
   1 та	відчуттям
   1 об	єктивізує
   1 об	єднуються
   1 не	підпадала
   1 не	процвітає
   1 не	поставити
   1 не	отримував
   1 не	здавалася
   1 не	виставить
   1 не	випадково
   1 на	саксофоні
   1 на	політичні
   1 на	поетичних
   1 на	Історичну
   1 ми	незалежно
   1 за	політичну
   1 за	допомогою
   1 до	створення
   1 до	спільного
   1 до	богемного
   1 де	навчилися
   1 Що	здавалося
   1 її	проблема
   1 її	особиста
   1 як	політика
   1 цю	табличку
   1 це	відчуття
   1 та	тюремних
   1 та	сумління
   1 об	єднувала
   1 об	єднатися
   1 не	прийняли
   1 не	називали
   1 не	зламався
   1 не	залежить
   1 не	говорить
   1 на	таємниці
   1 на	навчання
   1 на	молодого
   1 ми	нездатні
   1 за	потрібне
   1 до	сьогодні
   1 до	екології
   1 На	поручнях
   1 До	сьогодні
   1 її	позиція
   1 як	історія
   1 ці	поняття
   1 це	історія
   1 це	ключове
   1 ти	місяців
   1 та	причини
   1 та	приклад
   1 та	Роллінг
   1 та	Майклом
   1 та	Америки
   1 по	маминій
   1 ні	Система
   1 не	ідеалом
   1 не	пройшла
   1 не	повинна
   1 не	залишає
   1 на	якомусь
   1 на	початку
   1 на	кожному
   1 на	відміну
   1 на	виборах
   1 за	видимим
   1 за	Гавелом
   1 до	страйку
   1 до	природи
   1 На	початку
   1 Ми	повинні
   1 її	згодом
   1 із	одного
   1 як	спроба
   1 як	зразок
   1 це	робить
   1 це	основа
   1 ув	язненя
   1 ув	язнень
   1 та	період
   1 та	людини
   1 та	зуміти
   1 та	Правда
   1 та	Заходу
   1 по	цілому
   1 об	єднань
   1 не	просто
   1 не	вірить
   1 не	вважає
   1 на	моралі
   1 на	кшталт
   1 на	вибори
   1 на	Майдан
   1 ми	своїми
   1 за	іншого
   1 за	партію
   1 за	межами
   1 ви	навіть
   1 ба	більше
   1 На	посаді
   1 На	вибори
   1 Ви	можете
   1 як	Гавел
   1 що	існує
   1 що	хтось
   1 що	ніхто
   1 чи	Левко
   1 ця	зміна
   1 це	різні
   1 це	пізні
   1 це	життя
   1 та	одним
   1 та	дідом
   1 не	шукав
   1 не	треба
   1 не	помер
   1 не	зможе
   1 не	думає
   1 не	віриш
   1 на	якого
   1 на	таких
   1 на	своїй
   1 на	нього
   1 на	життя
   1 на	Граді
   1 ми	їдемо
   1 за	існує
   1 за	темою
   1 за	роком
   1 до	цього
   1 до	світу
   1 до	Ольги
   1 ви	новий
   1 бо	Гавел
   1 би	Богом
   1 Як	кожен
   1 Це	схоже
   1 Це	надія
   1 Не	важко
   1 На	думку
   1 Ми	знову
   1 що	ідеї
   1 що	щось
   1 що	йому
   1 що	всім
   1 що	будь
   1 ще	одну
   1 чи	Емір
   1 ці	люди
   1 це	щось
   1 ті	самі
   1 та	хіпі
   1 та	пише
   1 та	пили
   1 та	ледь
   1 та	його
   1 рр	Фото
   1 по	суті
   1 по	собі
   1 он	лайн
   1 не	стає
   1 не	дуже
   1 на	тези
   1 на	себе
   1 на	волю
   1 за	світ
   1 за	свої
   1 за	своє
   1 за	нами
   1 до	Сили
   1 аж	ніяк
   1 Це	може
   1 То	чому
   1 що	так
   1 що	гра
   1 що	він
   1 що	всі
   1 що	ваш
   1 чи	тим
   1 цю	гру
   1 це	теж
   1 це	для
   1 це	все
   1 це	був
   1 та	був
   1 не	має
   1 на	всі
   1 на	бік
   1 ми	все
   1 же	час
   1 Це	гра
   1 їх	об
   1 як	її
   1 як	би
   1 що	це
   1 що	об
   1 що	ви
   1 чи	як
   1 чи	об
   1 чи	ні
   1 чи	за
   1 це	те
   1 ти	не
   1 те	за
   1 та	їх
   1 та	до
   1 не	те
   1 на	те
   1 ми	не
   1 за	це
   1 би	ми
   1 Це	її
   1 Це	не
   1 ім	я
   1 як	і
   1 що	у
   1 що	з
   1 ще	в
   1 та	Е
   1 до	в
   1 до	9
   1 до	2003
   1 в30	ті
   1 б	безперспективною
   1 і	малодослідженим
   1 у	Чехословаччину
   1 в	правозахисному
   1 і	середньовічна
   1 і	масариківська
   1 є	впорядкованим
   1 у	світобаченні
   1 у	Варшавському
   1 з	усвідомлення
   1 в	університеті
   1 в	найдрібніших
   1 з	соратниками
   1 з	пролетарями
   1 ж	залишається
   1 в	характерній
   1 в	позитивному
   1 і	світогляду
   1 і	засуджують
   1 і	закордоном
   1 і	демократію
   1 є	незнищенно
   1 є	наскрізною
   1 є	вкоріненим
   1 у	соціальних
   1 у	матеріалах
   1 з	посиланням
   1 з	політичних
   1 в	російській
   1 в	мистецьких
   1 в	масонських
   1 а	відповідно
   1 І	повернення
   1 і	режисером
   1 і	революція
   1 і	президент
   1 і	мільйонів
   1 і	драматург
   1 є	практична
   1 з	поглядами
   1 з	офіційної
   1 з	Січеслава
   1 ж	новорічне
   1 в	суспільні
   1 в	пивзаводі
   1 в	парламент
   1 в	місцевому
   1 в	дитинстві
   1 в	атмосфері
   1 б	незначний
   1 Г	Масариком
   1 В	пізнішому
   1 І	достатньо
   1 і	словаків
   1 і	політика
   1 і	небідною
   1 і	запрошує
   1 і	виводить
   1 у	виборчій
   1 й	водночас
   1 з	системою
   1 з	молодшим
   1 з	головних
   1 в	місцевих
   1 в	молодому
   1 Ю	ГОЛОКОСТ
   1 Л	Брєжнєва
   1 В	ятровичу
   1 І	водночас
   1 і	справді
   1 є	справді
   1 у	шухляду
   1 у	вітрині
   1 з	ясували
   1 з	околиць
   1 з	написом
   1 з	друзями
   1 з	ЛуРідом
   1 в	якомусь
   1 в	театрах
   1 в	столиці
   1 в	природу
   1 в	останні
   1 в	Україні
   1 в	Америку
   1 М	Гавелом
   1 В	язничне
   1 В	певному
   1 В	останні
   1 і	перший
   1 і	пароль
   1 і	надалі
   1 є	цілком
   1 у	травні
   1 у	відділ
   1 з	нагоди
   1 з	листів
   1 ж	надією
   1 в	умовах
   1 в	травні
   1 в	своєму
   1 в	самому
   1 в	роботі
   1 в	період
   1 в	кінець
   1 в	жовтні
   1 в	грудні
   1 в	брехні
   1 в	Хартії
   1 в	Листах
   1 в	Гавела
   1 а	просто
   1 а	людина
   1 а	згодом
   1 М	Дрібна
   1 В	одному
   1 і	після
   1 і	любов
   1 і	зараз
   1 і	дійти
   1 і	Пласт
   1 є	життя
   1 я	якого
   1 х	після
   1 х	Гавел
   1 у	тюрмі
   1 у	самій
   1 у	місті
   1 у	Празі
   1 з	якого
   1 з	Праги
   1 ж	нехай
   1 ж	місця
   1 в	тюрмі
   1 в	сфері
   1 в	світі
   1 в	самих
   1 в	одній
   1 в	нього
   1 в	жанрі
   1 в	епоху
   1 в	групі
   1 в	Празі
   1 М	Гавел
   1 В	цьому
   1 В	кінці
   1 І	криза
   1 І	знову
   1 і	щось
   1 і	тоді
   1 і	смог
   1 і	свої
   1 і	саме
   1 і	ледь
   1 і	веде
   1 і	будь
   1 є	сила
   1 є	сенс
   1 є	десь
   1 я	якою
   1 я	була
   1 р	Фото
   1 з	їзді
   1 з	цією
   1 з	його
   1 ж	теза
   1 ж	саме
   1 в	часи
   1 в	собі
   1 в	разі
   1 в	його
   1 в	будь
   1 а	тому
   1 а	люди
   1 а	Білл
   1 З	цією
   1 В	Силі
   1 А	бунт
   1 і	тут
   1 і	міф
   1 і	для
   1 і	дає
   1 х	для
   1 в	які
   1 в	тих
   1 в	ряд
   1 в	неї
   1 б	тут
   1 а	вже
   1 М	Для
   1 В	цій
   1 А	вже
   1 І	без
   1 і	її
   1 і	як
   1 і	що
   1 і	це
   1 і	за
   1 й	за
   1 в	цю
   1 в	те
   1 а	не
   1 М	Це
   1 І	ця
   1 а	в30
   1 і	з
   1 я	і
   1 х	і
   1 х	з
   1 у	в
   1 б	і
   1 а	й
   1 ж	d3e7e93
   1 у	1978
   1 в	1978
   1 В	1966
   1 В	1963
   1 у	1960
   1 В	1950
   1 zpravy	idnes
   1 zakleteknihy	cz
   1 the	Universe
   1 skrytemesto	cz
   1 png	Twitter
   1 png	Facebook
   1 of	the
   1 net	Вузловим
   1 mapa	skrytemesto
   1 kultura	zpravy
   1 jpg	Загальновідомо
   1 jpg	Радянські
   1 jpg	Литовські
   1 jpg	Радомир
   1 jpg	Київ
   1 jpg	В
   1 ico02	png
   1 ico01	png
   1 f8b4e34	300
   1 d95acc5	2
   1 d3e7e93	3
   1 cz	Сучасна
   1 cz	Родинна
   1 cz	Далі
   1 cz	На
   1 cz	60
   1 brno	idnes
   1 blesk	cz
   1 a377da3	135
   1 ____________________	Українська
   1 _	Радомир
   1 _	Вахтанг
   1 _	Юрій
   1 _	Леся
   1 _	Яна
   1 Zabradli	відбувається
   1 XX	сторіччя
   1 X	Запам
   1 VONS	Гавел
   1 Universe	який
   1 Twitter	
   1 RSS	ЗНАЙТИ
   1 Plastic	People
   1 People	of
   1 Opinions	Життя
   1 Na	Zabradli
   1 L	INS
   1 Kurovce	Чогось
   1 INT	L
   1 INS	Коротко
   1 INS	ТАБЛОID
   1 INS	Сила
   1 INS	a377da3
   1 Facebook	ico02
   1 FAMU	де
   1 Dana	Kurovce
   1 Concurring	Opinions
   1 Bigmir	net
   1 Antikvariat	Dana
   1 941a97a	3
   1 93e096e	1
   1 90	х
   1 9	ти
   1 80	ті
   1 77	Характерно
   1 77	чи
   1 60	ті
   1 60	jpg
   1 5d7e1ff	60
   1 55a0ddd	2
   1 50	х
   1 47	Посольство
   1 43	2010
   1 4	jpg
   1 3fb1780	1
   1 3a8dd2d	3
   1 36677ef	137
   1 36	Власне
   1 300	jpg
   1 3	jpg
   1 3	2
   1 3	1
   1 28	12
   1 25	12
   1 24	12
   1 21	12
   1 2018	Українська
   1 2010	2018
   1 2003	року
   1 1ee2c8d	4
   1 1990	року
   1 1990	рік
   1 1990	в
   1 1989	фінал
   1 1982	роки
   1 1980	року
   1 1979	1982
   1 1976	рік
   1 1975	рр
   1 1974	1975
   1 1970	років
   1 1969	хокеїсти
   1 1968	Окупація
   1 1968	рік
   1 1968	р
   1 1966	його
   1 1963	році
   1 1960	створював
   1 1953	5d7e1ff
   1 1950	х
   1 1948	року
   1 1945	1953
   1 1943	КАНАДІАНА
   1 1936	року
   1 19	На
   1 137	jpg
   1 135	jpg
   1 100	РЕФОРМАЦІЯ
   1 10	2018
   1 1	січня
   1 1	2
   1 1	1
   1 0fb3aa7	1
   1 07	Вінницький
   1 06	10
   1 05	19
   1 05	07
   1 04	47
   1 04	00
   1 02	43
   1 00	Помер
